"","year","period","periodName","unemployed","labor.force","unemployment.rate","date","location","employed"
"1","2020","M01","January",12932,283341,0.0456411179462203,2020-01-01,"Albuquerque, NM",270409
"2","2020","M02","February",12709,284831,0.0446194410018572,2020-02-01,"Albuquerque, NM",272122
"3","2020","M03","March",13723,281653,0.048723074137325,2020-03-01,"Albuquerque, NM",267930
"4","2020","M04","April",28992,268398,0.10801868866385,2020-04-01,"Albuquerque, NM",239406
"5","2020","M05","May",28594,268074,0.106664577691235,2020-05-01,"Albuquerque, NM",239480
"6","2020","M06","June",27489,271195,0.101362488246465,2020-06-01,"Albuquerque, NM",243706
"7","2020","M07","July",36795,280503,0.131175067646335,2020-07-01,"Albuquerque, NM",243708
"8","2020","M08","August",24743,272827,0.0906911705952857,2020-08-01,"Albuquerque, NM",248084
"9","2020","M09","September",23902,286337,0.0834750660934493,2020-09-01,"Albuquerque, NM",262435
"10","2020","M10","October",21708,282257,0.0769086329125584,2020-10-01,"Albuquerque, NM",260549
"11","2020","M11","November",21668,282253,0.0767680060087935,2020-11-01,"Albuquerque, NM",260585
"12","2020","M12","December",23046,283911,0.0811733254435369,2020-12-01,"Albuquerque, NM",260865
"13","2021","M01","January",24161,281588,0.0858026620452576,2021-01-01,"Albuquerque, NM",257427
"14","2021","M02","February",21741,282279,0.0770195444932142,2021-02-01,"Albuquerque, NM",260538
"15","2021","M03","March",20432,279407,0.0731262996274252,2021-03-01,"Albuquerque, NM",258975
"16","2021","M04","April",19770,280333,0.0705232705389662,2021-04-01,"Albuquerque, NM",260563
"17","2021","M05","May",19268,277822,0.0693537588815861,2021-05-01,"Albuquerque, NM",258554
"18","2021","M06","June",22187,279735,0.0793143510822743,2021-06-01,"Albuquerque, NM",257548
"19","2021","M07","July",20492,280619,0.0730242784700965,2021-07-01,"Albuquerque, NM",260127
"20","2021","M08","August",16597,279689,0.0593409107973499,2021-08-01,"Albuquerque, NM",263092
"21","2021","M09","September",15085,277019,0.0544547485912519,2021-09-01,"Albuquerque, NM",261934
"22","2021","M10","October",13862,280263,0.04946068514217,2021-10-01,"Albuquerque, NM",266401
"23","2021","M11","November",13820,283479,0.048751406629768,2021-11-01,"Albuquerque, NM",269659
"24","2021","M12","December",12501,282488,0.0442532072158817,2021-12-01,"Albuquerque, NM",269987
"25","2020","M01","January",6307,150045,0.0420340564497317,2020-01-01,"Anchorage Borough, AK",143738
"26","2020","M02","February",5901,148989,0.0396069508487204,2020-02-01,"Anchorage Borough, AK",143088
"27","2020","M03","March",7470,148587,0.0502735770962466,2020-03-01,"Anchorage Borough, AK",141117
"28","2020","M04","April",18157,146093,0.12428384659087,2020-04-01,"Anchorage Borough, AK",127936
"29","2020","M05","May",17307,148097,0.116862596811549,2020-05-01,"Anchorage Borough, AK",130790
"30","2020","M06","June",16111,148057,0.108816199166537,2020-06-01,"Anchorage Borough, AK",131946
"31","2020","M07","July",14809,148495,0.0997272635442271,2020-07-01,"Anchorage Borough, AK",133686
"32","2020","M08","August",9025,142607,0.0632858134593673,2020-08-01,"Anchorage Borough, AK",133582
"33","2020","M09","September",9352,142512,0.0656225440664646,2020-09-01,"Anchorage Borough, AK",133160
"34","2020","M10","October",8815,152130,0.0579438638006968,2020-10-01,"Anchorage Borough, AK",143315
"35","2020","M11","November",9033,152637,0.0591796222410032,2020-11-01,"Anchorage Borough, AK",143604
"36","2020","M12","December",9364,152457,0.0614205972831684,2020-12-01,"Anchorage Borough, AK",143093
"37","2021","M01","January",9452,149486,0.0632300014717097,2021-01-01,"Anchorage Borough, AK",140034
"38","2021","M02","February",9704,148636,0.0652870098764768,2021-02-01,"Anchorage Borough, AK",138932
"39","2021","M03","March",10012,147944,0.0676742551235603,2021-03-01,"Anchorage Borough, AK",137932
"40","2021","M04","April",9645,149473,0.0645267038194189,2021-04-01,"Anchorage Borough, AK",139828
"41","2021","M05","May",8866,150100,0.0590672884743504,2021-05-01,"Anchorage Borough, AK",141234
"42","2021","M06","June",9055,148916,0.0608060920250342,2021-06-01,"Anchorage Borough, AK",139861
"43","2021","M07","July",8245,147816,0.0557788060832386,2021-07-01,"Anchorage Borough, AK",139571
"44","2021","M08","August",7004,146529,0.0477994117205468,2021-08-01,"Anchorage Borough, AK",139525
"45","2021","M09","September",7160,146976,0.0487154365338559,2021-09-01,"Anchorage Borough, AK",139816
"46","2021","M10","October",7007,148915,0.0470536883457006,2021-10-01,"Anchorage Borough, AK",141908
"47","2021","M11","November",7137,151633,0.0470675908278541,2021-11-01,"Anchorage Borough, AK",144496
"48","2021","M12","December",6722,152303,0.0441357031706532,2021-12-01,"Anchorage Borough, AK",145581
"49","2020","M01","January",6307,150045,0.0420340564497317,2020-01-01,"Anchorage, AK",143738
"50","2020","M02","February",5901,148989,0.0396069508487204,2020-02-01,"Anchorage, AK",143088
"51","2020","M03","March",7470,148587,0.0502735770962466,2020-03-01,"Anchorage, AK",141117
"52","2020","M04","April",18157,146093,0.12428384659087,2020-04-01,"Anchorage, AK",127936
"53","2020","M05","May",17307,148097,0.116862596811549,2020-05-01,"Anchorage, AK",130790
"54","2020","M06","June",16111,148057,0.108816199166537,2020-06-01,"Anchorage, AK",131946
"55","2020","M07","July",14809,148495,0.0997272635442271,2020-07-01,"Anchorage, AK",133686
"56","2020","M08","August",9025,142607,0.0632858134593673,2020-08-01,"Anchorage, AK",133582
"57","2020","M09","September",9352,142512,0.0656225440664646,2020-09-01,"Anchorage, AK",133160
"58","2020","M10","October",8815,152130,0.0579438638006968,2020-10-01,"Anchorage, AK",143315
"59","2020","M11","November",9033,152637,0.0591796222410032,2020-11-01,"Anchorage, AK",143604
"60","2020","M12","December",9364,152457,0.0614205972831684,2020-12-01,"Anchorage, AK",143093
"61","2021","M01","January",9452,149486,0.0632300014717097,2021-01-01,"Anchorage, AK",140034
"62","2021","M02","February",9704,148636,0.0652870098764768,2021-02-01,"Anchorage, AK",138932
"63","2021","M03","March",10012,147944,0.0676742551235603,2021-03-01,"Anchorage, AK",137932
"64","2021","M04","April",9645,149473,0.0645267038194189,2021-04-01,"Anchorage, AK",139828
"65","2021","M05","May",8866,150100,0.0590672884743504,2021-05-01,"Anchorage, AK",141234
"66","2021","M06","June",9055,148916,0.0608060920250342,2021-06-01,"Anchorage, AK",139861
"67","2021","M07","July",8245,147816,0.0557788060832386,2021-07-01,"Anchorage, AK",139571
"68","2021","M08","August",7004,146529,0.0477994117205468,2021-08-01,"Anchorage, AK",139525
"69","2021","M09","September",7160,146976,0.0487154365338559,2021-09-01,"Anchorage, AK",139816
"70","2021","M10","October",7007,148915,0.0470536883457006,2021-10-01,"Anchorage, AK",141908
"71","2021","M11","November",7137,151633,0.0470675908278541,2021-11-01,"Anchorage, AK",144496
"72","2021","M12","December",6722,152303,0.0441357031706532,2021-12-01,"Anchorage, AK",145581
"73","2020","M01","January",9755,321859,0.0303083027039791,2020-01-01,"Anne Arundel County, MD",312104
"74","2020","M02","February",9530,322714,0.0295307919705994,2020-02-01,"Anne Arundel County, MD",313184
"75","2020","M03","March",10407,321896,0.0323303178666402,2020-03-01,"Anne Arundel County, MD",311489
"76","2020","M04","April",26241,304726,0.0861134264880581,2020-04-01,"Anne Arundel County, MD",278485
"77","2020","M05","May",26375,306455,0.0860648382307353,2020-05-01,"Anne Arundel County, MD",280080
"78","2020","M06","June",24306,319052,0.0761819389942705,2020-06-01,"Anne Arundel County, MD",294746
"79","2020","M07","July",23448,310437,0.0755322335932895,2020-07-01,"Anne Arundel County, MD",286989
"80","2020","M08","August",21878,308147,0.0709985818456775,2020-08-01,"Anne Arundel County, MD",286269
"81","2020","M09","September",16634,293081,0.056755640932029,2020-09-01,"Anne Arundel County, MD",276447
"82","2020","M10","October",15902,304571,0.0522111428862236,2020-10-01,"Anne Arundel County, MD",288669
"83","2020","M11","November",16293,306463,0.0531646560922526,2020-11-01,"Anne Arundel County, MD",290170
"84","2020","M12","December",16482,305553,0.0539415420565336,2020-12-01,"Anne Arundel County, MD",289071
"85","2021","M01","January",15852,302302,0.052437628596569,2021-01-01,"Anne Arundel County, MD",286450
"86","2021","M02","February",15415,302558,0.0509489089695199,2021-02-01,"Anne Arundel County, MD",287143
"87","2021","M03","March",15073,305037,0.0494136776850021,2021-03-01,"Anne Arundel County, MD",289964
"88","2021","M04","April",14379,305357,0.0470891448370268,2021-04-01,"Anne Arundel County, MD",290978
"89","2021","M05","May",14732,306128,0.0481236606909528,2021-05-01,"Anne Arundel County, MD",291396
"90","2021","M06","June",17393,310569,0.0560036578022919,2021-06-01,"Anne Arundel County, MD",293176
"91","2021","M07","July",14783,313153,0.0472069563440235,2021-07-01,"Anne Arundel County, MD",298370
"92","2021","M08","August",14660,309385,0.0473843269712494,2021-08-01,"Anne Arundel County, MD",294725
"93","2021","M09","September",13681,306669,0.0446116170855222,2021-09-01,"Anne Arundel County, MD",292988
"94","2021","M10","October",12823,307588,0.0416888825311781,2021-10-01,"Anne Arundel County, MD",294765
"95","2021","M11","November",11841,308397,0.0383953151295246,2021-11-01,"Anne Arundel County, MD",296556
"96","2021","M12","December",10161,307332,0.0330619655616727,2021-12-01,"Anne Arundel County, MD",297171
"97","2020","M01","January",10228,367609,0.0278230402411258,2020-01-01,"Arapahoe County, CO",357381
"98","2020","M02","February",10145,368989,0.0274940445379131,2020-02-01,"Arapahoe County, CO",358844
"99","2020","M03","March",17449,360457,0.0484079931864272,2020-03-01,"Arapahoe County, CO",343008
"100","2020","M04","April",43653,348344,0.125315779803872,2020-04-01,"Arapahoe County, CO",304691
"101","2020","M05","May",45861,364169,0.125933289214623,2020-05-01,"Arapahoe County, CO",318308
"102","2020","M06","June",46245,374676,0.123426640617494,2020-06-01,"Arapahoe County, CO",328431
"103","2020","M07","July",30823,363263,0.0848503701175182,2020-07-01,"Arapahoe County, CO",332440
"104","2020","M08","August",29787,368688,0.0807918890769431,2020-08-01,"Arapahoe County, CO",338901
"105","2020","M09","September",28887,371107,0.0778400838572164,2020-09-01,"Arapahoe County, CO",342220
"106","2020","M10","October",27826,369836,0.0752387544749565,2020-10-01,"Arapahoe County, CO",342010
"107","2020","M11","November",27803,373862,0.0743670124270453,2020-11-01,"Arapahoe County, CO",346059
"108","2020","M12","December",27196,370217,0.0734596196284882,2020-12-01,"Arapahoe County, CO",343021
"109","2021","M01","January",26670,370610,0.0719624403011252,2021-01-01,"Arapahoe County, CO",343940
"110","2021","M02","February",25799,372685,0.0692246803600896,2021-02-01,"Arapahoe County, CO",346886
"111","2021","M03","March",25335,369987,0.0684753788646628,2021-03-01,"Arapahoe County, CO",344652
"112","2021","M04","April",25001,374491,0.0667599488372217,2021-04-01,"Arapahoe County, CO",349490
"113","2021","M05","May",23312,374294,0.0622825906907404,2021-05-01,"Arapahoe County, CO",350982
"114","2021","M06","June",24953,376495,0.0662771085937396,2021-06-01,"Arapahoe County, CO",351542
"115","2021","M07","July",24329,375682,0.0647595572851507,2021-07-01,"Arapahoe County, CO",351353
"116","2021","M08","August",21783,375952,0.0579409073498744,2021-08-01,"Arapahoe County, CO",354169
"117","2021","M09","September",19774,379525,0.0521019695672222,2021-09-01,"Arapahoe County, CO",359751
"118","2021","M10","October",18551,378579,0.0490016614762044,2021-10-01,"Arapahoe County, CO",360028
"119","2021","M11","November",18008,379817,0.0474123064528444,2021-11-01,"Arapahoe County, CO",361809
"120","2021","M12","December",16943,378546,0.0447581007328039,2021-12-01,"Arapahoe County, CO",361603
"121","2020","M01","January",7109,214165,0.0331940326383863,2020-01-01,"Arlington, TX",207056
"122","2020","M02","February",6845,215395,0.0317788249495114,2020-02-01,"Arlington, TX",208550
"123","2020","M03","March",9582,210528,0.0455141358869129,2020-03-01,"Arlington, TX",200946
"124","2020","M04","April",29249,204798,0.142818777527124,2020-04-01,"Arlington, TX",175549
"125","2020","M05","May",27433,208425,0.131620486985726,2020-05-01,"Arlington, TX",180992
"126","2020","M06","June",23584,215840,0.109266123054114,2020-06-01,"Arlington, TX",192256
"127","2020","M07","July",20668,214200,0.0964892623716153,2020-07-01,"Arlington, TX",193532
"128","2020","M08","August",14632,214555,0.0681969658129617,2020-08-01,"Arlington, TX",199923
"129","2020","M09","September",16356,212894,0.0768269655321428,2020-09-01,"Arlington, TX",196538
"130","2020","M10","October",14095,217021,0.0649476317960013,2020-10-01,"Arlington, TX",202926
"131","2020","M11","November",14054,215704,0.0651541000630494,2020-11-01,"Arlington, TX",201650
"132","2020","M12","December",13776,217239,0.0634140278679243,2020-12-01,"Arlington, TX",203463
"133","2021","M01","January",15034,214932,0.0699477043902257,2021-01-01,"Arlington, TX",199898
"134","2021","M02","February",15549,213275,0.0729058726995663,2021-02-01,"Arlington, TX",197726
"135","2021","M03","March",15002,214240,0.0700242718446602,2021-03-01,"Arlington, TX",199238
"136","2021","M04","April",13339,214007,0.0623297368777657,2021-04-01,"Arlington, TX",200668
"137","2021","M05","May",12184,214050,0.0569212800747489,2021-05-01,"Arlington, TX",201866
"138","2021","M06","June",13322,214298,0.062165769162568,2021-06-01,"Arlington, TX",200976
"139","2021","M07","July",11858,214572,0.0552635012956024,2021-07-01,"Arlington, TX",202714
"140","2021","M08","August",10631,215460,0.04934094495498,2021-08-01,"Arlington, TX",204829
"141","2021","M09","September",9857,217778,0.0452616885084811,2021-09-01,"Arlington, TX",207921
"142","2021","M10","October",9501,219361,0.0433121657906374,2021-10-01,"Arlington, TX",209860
"143","2021","M11","November",8939,221942,0.040276288399672,2021-11-01,"Arlington, TX",213003
"144","2021","M12","December",8321,221970,0.0374870477992522,2021-12-01,"Arlington, TX",213649
"145","2020","M01","January",10193,267492,0.0381058125102807,2020-01-01,"Atlanta, GA",257299
"146","2020","M02","February",9957,269066,0.0370057904008682,2020-02-01,"Atlanta, GA",259109
"147","2020","M03","March",12335,268709,0.0459046775508078,2020-03-01,"Atlanta, GA",256374
"148","2020","M04","April",34326,255298,0.134454637325792,2020-04-01,"Atlanta, GA",220972
"149","2020","M05","May",32279,262844,0.122806683812451,2020-05-01,"Atlanta, GA",230565
"150","2020","M06","June",31599,263566,0.119890274162828,2020-06-01,"Atlanta, GA",231967
"151","2020","M07","July",29799,263144,0.113242179187061,2020-07-01,"Atlanta, GA",233345
"152","2020","M08","August",24587,257984,0.0953043599603076,2020-08-01,"Atlanta, GA",233397
"153","2020","M09","September",23871,258837,0.0922240637930435,2020-09-01,"Atlanta, GA",234966
"154","2020","M10","October",20081,266051,0.0754780098552533,2020-10-01,"Atlanta, GA",245970
"155","2020","M11","November",18814,265874,0.0707628425494783,2020-11-01,"Atlanta, GA",247060
"156","2020","M12","December",20006,267337,0.074834385064544,2020-12-01,"Atlanta, GA",247331
"157","2021","M01","January",16726,263255,0.0635353554538375,2021-01-01,"Atlanta, GA",246529
"158","2021","M02","February",15509,266183,0.0582644271046611,2021-02-01,"Atlanta, GA",250674
"159","2021","M03","March",14243,267038,0.053336978257776,2021-03-01,"Atlanta, GA",252795
"160","2021","M04","April",13957,267981,0.0520820505931391,2021-04-01,"Atlanta, GA",254024
"161","2021","M05","May",14160,266915,0.0530505966318866,2021-05-01,"Atlanta, GA",252755
"162","2021","M06","June",16109,269664,0.0597373027174558,2021-06-01,"Atlanta, GA",253555
"163","2021","M07","July",11300,268111,0.0421467228125664,2021-07-01,"Atlanta, GA",256811
"164","2021","M08","August",10843,265839,0.0407878452747716,2021-08-01,"Atlanta, GA",254996
"165","2021","M09","September",8624,266232,0.032392800264431,2021-09-01,"Atlanta, GA",257608
"166","2021","M10","October",8193,267324,0.0306482021816223,2021-10-01,"Atlanta, GA",259131
"167","2021","M11","November",6924,268034,0.0258325436325242,2021-11-01,"Atlanta, GA",261110
"168","2021","M12","December",7649,269277,0.0284056937651563,2021-12-01,"Atlanta, GA",261628
"169","2020","M01","January",7630,120865,0.0631282836222231,2020-01-01,"Atlantic County, NJ",113235
"170","2020","M02","February",7305,122716,0.0595276899507807,2020-02-01,"Atlantic County, NJ",115411
"171","2020","M03","March",7640,122921,0.0621537410206555,2020-03-01,"Atlantic County, NJ",115281
"172","2020","M04","April",42215,122834,0.343675203933764,2020-04-01,"Atlantic County, NJ",80619
"173","2020","M05","May",43455,120815,0.35968215867235,2020-05-01,"Atlantic County, NJ",77360
"174","2020","M06","June",42624,123246,0.345844895574704,2020-06-01,"Atlantic County, NJ",80622
"175","2020","M07","July",29690,128333,0.231351250262988,2020-07-01,"Atlantic County, NJ",98643
"176","2020","M08","August",21366,123046,0.173642377647384,2020-08-01,"Atlantic County, NJ",101680
"177","2020","M09","September",13586,116607,0.11651101563371,2020-09-01,"Atlantic County, NJ",103021
"178","2020","M10","October",12345,115921,0.106494940519837,2020-10-01,"Atlantic County, NJ",103576
"179","2020","M11","November",17098,120334,0.142087855468945,2020-11-01,"Atlantic County, NJ",103236
"180","2020","M12","December",12935,114806,0.112668327439332,2020-12-01,"Atlantic County, NJ",101871
"181","2021","M01","January",14446,115264,0.125329677956691,2021-01-01,"Atlantic County, NJ",100818
"182","2021","M02","February",14502,116577,0.124398466249775,2021-02-01,"Atlantic County, NJ",102075
"183","2021","M03","March",13611,117055,0.116278672418948,2021-03-01,"Atlantic County, NJ",103444
"184","2021","M04","April",12604,116613,0.10808400435629,2021-04-01,"Atlantic County, NJ",104009
"185","2021","M05","May",12180,118079,0.103151280075204,2021-05-01,"Atlantic County, NJ",105899
"186","2021","M06","June",13587,121877,0.111481247487221,2021-06-01,"Atlantic County, NJ",108290
"187","2021","M07","July",12943,121132,0.106850378099924,2021-07-01,"Atlantic County, NJ",108189
"188","2021","M08","August",11705,119351,0.0980720731288385,2021-08-01,"Atlantic County, NJ",107646
"189","2021","M09","September",10612,117272,0.0904904836619142,2021-09-01,"Atlantic County, NJ",106660
"190","2021","M10","October",9338,118505,0.0787983629382727,2021-10-01,"Atlantic County, NJ",109167
"191","2021","M11","November",8934,118091,0.075653521436858,2021-11-01,"Atlantic County, NJ",109157
"192","2021","M12","December",8748,118767,0.0736568238652151,2021-12-01,"Atlantic County, NJ",110019
"193","2020","M01","January",15293,597614,0.0255900966175491,2020-01-01,"Austin, TX",582321
"194","2020","M02","February",14821,602804,0.0245867645204743,2020-02-01,"Austin, TX",587983
"195","2020","M03","March",21278,587138,0.0362402024736944,2020-03-01,"Austin, TX",565860
"196","2020","M04","April",67960,558373,0.121710756071658,2020-04-01,"Austin, TX",490413
"197","2020","M05","May",60666,566371,0.107113535120972,2020-05-01,"Austin, TX",505705
"198","2020","M06","June",52327,590511,0.0886130825674712,2020-06-01,"Austin, TX",538184
"199","2020","M07","July",47536,590920,0.0804440533405537,2020-07-01,"Austin, TX",543384
"200","2020","M08","August",33643,596770,0.0563751529064799,2020-08-01,"Austin, TX",563127
"201","2020","M09","September",37119,591486,0.0627555005528449,2020-09-01,"Austin, TX",554367
"202","2020","M10","October",30929,600801,0.0514796080565778,2020-10-01,"Austin, TX",569872
"203","2020","M11","November",29883,593896,0.0503168904993467,2020-11-01,"Austin, TX",564013
"204","2020","M12","December",28378,598704,0.0473990486116679,2020-12-01,"Austin, TX",570326
"205","2021","M01","January",30742,594586,0.0517032018917364,2021-01-01,"Austin, TX",563844
"206","2021","M02","February",32197,596715,0.0539570816889135,2021-02-01,"Austin, TX",564518
"207","2021","M03","March",30607,599704,0.0510368448434561,2021-03-01,"Austin, TX",569097
"208","2021","M04","April",26604,601191,0.044252159463465,2021-04-01,"Austin, TX",574587
"209","2021","M05","May",24595,601957,0.0408584001847308,2021-05-01,"Austin, TX",577362
"210","2021","M06","June",27028,603462,0.0447882385303466,2021-06-01,"Austin, TX",576434
"211","2021","M07","July",23984,610233,0.039303020321746,2021-07-01,"Austin, TX",586249
"212","2021","M08","August",21431,612577,0.0349849896421185,2021-08-01,"Austin, TX",591146
"213","2021","M09","September",20253,617667,0.0327895127957297,2021-09-01,"Austin, TX",597414
"214","2021","M10","October",19778,625389,0.0316251165274733,2021-10-01,"Austin, TX",605611
"215","2021","M11","November",18985,630976,0.0300883076376914,2021-11-01,"Austin, TX",611991
"216","2021","M12","December",17134,629228,0.0272301931891143,2021-12-01,"Austin, TX",612094
"217","2020","M01","January",10394,178446,0.0582473129125898,2020-01-01,"Bakersfield, CA",168052
"218","2020","M02","February",9687,175706,0.0551318680067841,2020-02-01,"Bakersfield, CA",166019
"219","2020","M03","March",11202,172323,0.0650058320711687,2020-03-01,"Bakersfield, CA",161121
"220","2020","M04","April",29290,172162,0.170130458521625,2020-04-01,"Bakersfield, CA",142872
"221","2020","M05","May",28321,177493,0.159561222132704,2020-05-01,"Bakersfield, CA",149172
"222","2020","M06","June",26465,177902,0.148761677777653,2020-06-01,"Bakersfield, CA",151437
"223","2020","M07","July",26628,177546,0.149978033861647,2020-07-01,"Bakersfield, CA",150918
"224","2020","M08","August",24040,181278,0.132613996182659,2020-08-01,"Bakersfield, CA",157238
"225","2020","M09","September",21858,179946,0.121469774265613,2020-09-01,"Bakersfield, CA",158088
"226","2020","M10","October",18570,181440,0.102347883597884,2020-10-01,"Bakersfield, CA",162870
"227","2020","M11","November",14799,176623,0.0837886345492943,2020-11-01,"Bakersfield, CA",161824
"228","2020","M12","December",16647,175333,0.0949450474240445,2020-12-01,"Bakersfield, CA",158686
"229","2021","M01","January",15644,174457,0.0896725267544438,2021-01-01,"Bakersfield, CA",158813
"230","2021","M02","February",14396,173097,0.0831672414888762,2021-02-01,"Bakersfield, CA",158701
"231","2021","M03","March",13300,166801,0.0797357329992026,2021-03-01,"Bakersfield, CA",153501
"232","2021","M04","April",13128,169478,0.0774613814182372,2021-04-01,"Bakersfield, CA",156350
"233","2021","M05","May",12769,172493,0.0740261923672265,2021-05-01,"Bakersfield, CA",159724
"234","2021","M06","June",14847,174646,0.0850119670648054,2021-06-01,"Bakersfield, CA",159799
"235","2021","M07","July",15844,173856,0.091132891588441,2021-07-01,"Bakersfield, CA",158012
"236","2021","M08","August",15670,178572,0.0877517191944986,2021-08-01,"Bakersfield, CA",162902
"237","2021","M09","September",13535,179001,0.07561410271451,2021-09-01,"Bakersfield, CA",165466
"238","2021","M10","October",12730,180346,0.0705865392079669,2021-10-01,"Bakersfield, CA",167616
"239","2021","M11","November",10675,179222,0.0595630000781154,2021-11-01,"Bakersfield, CA",168547
"240","2021","M12","December",9593,173279,0.0553615844966788,2021-12-01,"Bakersfield, CA",163686
"241","2020","M01","January",17049,460301,0.0370388072152787,2020-01-01,"Baltimore County, MD",443252
"242","2020","M02","February",16261,461063,0.0352684990988216,2020-02-01,"Baltimore County, MD",444802
"243","2020","M03","March",18267,460678,0.0396524253383057,2020-03-01,"Baltimore County, MD",442411
"244","2020","M04","April",40729,436234,0.0933650288606574,2020-04-01,"Baltimore County, MD",395505
"245","2020","M05","May",42289,440009,0.0961093977623185,2020-05-01,"Baltimore County, MD",397720
"246","2020","M06","June",39676,458499,0.0865345398790401,2020-06-01,"Baltimore County, MD",418823
"247","2020","M07","July",39608,447297,0.0885496661055183,2020-07-01,"Baltimore County, MD",407689
"248","2020","M08","August",37879,444636,0.0851910326649214,2020-08-01,"Baltimore County, MD",406757
"249","2020","M09","September",29076,421912,0.0689148448017596,2020-09-01,"Baltimore County, MD",392836
"250","2020","M10","October",27766,437909,0.0634058674290777,2020-10-01,"Baltimore County, MD",410143
"251","2020","M11","November",27984,440391,0.0635435329059858,2020-11-01,"Baltimore County, MD",412407
"252","2020","M12","December",28597,439408,0.0650807450023668,2020-12-01,"Baltimore County, MD",410811
"253","2021","M01","January",27676,434586,0.0636835977228903,2021-01-01,"Baltimore County, MD",406910
"254","2021","M02","February",26558,434453,0.0611297424577572,2021-02-01,"Baltimore County, MD",407895
"255","2021","M03","March",26503,438325,0.0604642673815092,2021-03-01,"Baltimore County, MD",411822
"256","2021","M04","April",25543,438860,0.058203071594586,2021-04-01,"Baltimore County, MD",413317
"257","2021","M05","May",25540,439312,0.0581363586699202,2021-05-01,"Baltimore County, MD",413772
"258","2021","M06","June",29175,445771,0.0654484028795054,2021-06-01,"Baltimore County, MD",416596
"259","2021","M07","July",24679,448490,0.0550268679346251,2021-07-01,"Baltimore County, MD",423811
"260","2021","M08","August",24411,443101,0.0550912771580294,2021-08-01,"Baltimore County, MD",418690
"261","2021","M09","September",23030,439222,0.0524336212666943,2021-09-01,"Baltimore County, MD",416192
"262","2021","M10","October",21740,440405,0.0493636539094697,2021-10-01,"Baltimore County, MD",418665
"263","2021","M11","November",19457,440829,0.0441372958675586,2021-11-01,"Baltimore County, MD",421372
"264","2021","M12","December",17304,439500,0.0393720136518771,2021-12-01,"Baltimore County, MD",422196
"265","2020","M01","January",30835,948459,0.032510630401525,2020-01-01,"Bexar County, TX",917624
"266","2020","M02","February",29693,954412,0.0311113020372753,2020-02-01,"Bexar County, TX",924719
"267","2020","M03","March",41979,931622,0.0450601209503425,2020-03-01,"Bexar County, TX",889643
"268","2020","M04","April",123136,894774,0.137616873087506,2020-04-01,"Bexar County, TX",771638
"269","2020","M05","May",112797,910375,0.123901688864479,2020-05-01,"Bexar County, TX",797578
"270","2020","M06","June",98196,948422,0.103536189586492,2020-06-01,"Bexar County, TX",850226
"271","2020","M07","July",91995,945119,0.0973369491037637,2020-07-01,"Bexar County, TX",853124
"272","2020","M08","August",65351,952559,0.0686057241598683,2020-08-01,"Bexar County, TX",887208
"273","2020","M09","September",73675,947504,0.0777569276752394,2020-09-01,"Bexar County, TX",873829
"274","2020","M10","October",63565,962833,0.0660187176800131,2020-10-01,"Bexar County, TX",899268
"275","2020","M11","November",62514,951322,0.0657127660245427,2020-11-01,"Bexar County, TX",888808
"276","2020","M12","December",59587,958124,0.0621913238787464,2020-12-01,"Bexar County, TX",898537
"277","2021","M01","January",64538,949485,0.0679715845958599,2021-01-01,"Bexar County, TX",884947
"278","2021","M02","February",66888,953371,0.0701594657274031,2021-02-01,"Bexar County, TX",886483
"279","2021","M03","March",64010,956420,0.0669266640179001,2021-03-01,"Bexar County, TX",892410
"280","2021","M04","April",56120,958490,0.058550428277812,2021-04-01,"Bexar County, TX",902370
"281","2021","M05","May",52099,955553,0.0545223551179265,2021-05-01,"Bexar County, TX",903454
"282","2021","M06","June",59101,965742,0.0611975040952967,2021-06-01,"Bexar County, TX",906641
"283","2021","M07","July",53263,964432,0.0552273255138776,2021-07-01,"Bexar County, TX",911169
"284","2021","M08","August",47765,959136,0.0498000283588563,2021-08-01,"Bexar County, TX",911371
"285","2021","M09","September",44568,970156,0.0459390036241594,2021-09-01,"Bexar County, TX",925588
"286","2021","M10","October",43009,974683,0.0441261415249881,2021-10-01,"Bexar County, TX",931674
"287","2021","M11","November",40865,980060,0.0416964267493827,2021-11-01,"Bexar County, TX",939195
"288","2021","M12","December",37212,974359,0.0381912621528615,2021-12-01,"Bexar County, TX",937147
"289","2020","M01","January",10926,393639,0.0277563960888022,2020-01-01,"Boston, MA",382713
"290","2020","M02","February",9751,394314,0.0247290230628382,2020-02-01,"Boston, MA",384563
"291","2020","M03","March",10321,389586,0.0264922250799567,2020-03-01,"Boston, MA",379265
"292","2020","M04","April",52908,353935,0.149485074943139,2020-04-01,"Boston, MA",301027
"293","2020","M05","May",58714,377934,0.155355167833537,2020-05-01,"Boston, MA",319220
"294","2020","M06","June",63479,394730,0.160816254148405,2020-06-01,"Boston, MA",331251
"295","2020","M07","July",43839,382681,0.114557555770995,2020-07-01,"Boston, MA",338842
"296","2020","M08","August",41056,388421,0.105699743319748,2020-08-01,"Boston, MA",347365
"297","2020","M09","September",39719,385511,0.103029485539972,2020-09-01,"Boston, MA",345792
"298","2020","M10","October",34890,388091,0.0899015952444143,2020-10-01,"Boston, MA",353201
"299","2020","M11","November",31538,388428,0.0811939407045836,2020-11-01,"Boston, MA",356890
"300","2020","M12","December",29328,387348,0.0757148610551752,2020-12-01,"Boston, MA",358020
"301","2021","M01","January",28941,388183,0.0745550423382786,2021-01-01,"Boston, MA",359242
"302","2021","M02","February",27244,389082,0.0700212294580577,2021-02-01,"Boston, MA",361838
"303","2021","M03","March",24279,387779,0.0626104043798143,2021-03-01,"Boston, MA",363500
"304","2021","M04","April",23294,388462,0.0599646812300817,2021-04-01,"Boston, MA",365168
"305","2021","M05","May",20238,386953,0.0523009254353888,2021-05-01,"Boston, MA",366715
"306","2021","M06","June",22550,391370,0.0576181107391982,2021-06-01,"Boston, MA",368820
"307","2021","M07","July",23538,394097,0.0597264125329551,2021-07-01,"Boston, MA",370559
"308","2021","M08","August",22164,394454,0.0561890613354155,2021-08-01,"Boston, MA",372290
"309","2021","M09","September",21624,389663,0.0554941064458263,2021-09-01,"Boston, MA",368039
"310","2021","M10","October",20508,391773,0.0523466395080825,2021-10-01,"Boston, MA",371265
"311","2021","M11","November",18019,393969,0.0457371011424757,2021-11-01,"Boston, MA",375950
"312","2021","M12","December",12786,388169,0.0329392609919906,2021-12-01,"Boston, MA",375383
"313","2020","M01","January",4642,195246,0.0237751349579505,2020-01-01,"Boulder County, CO",190604
"314","2020","M02","February",4705,198994,0.0236439289626823,2020-02-01,"Boulder County, CO",194289
"315","2020","M03","March",7876,193451,0.0407131521677324,2020-03-01,"Boulder County, CO",185575
"316","2020","M04","April",18337,182720,0.100355735551664,2020-04-01,"Boulder County, CO",164383
"317","2020","M05","May",18932,192829,0.0981802529702483,2020-05-01,"Boulder County, CO",173897
"318","2020","M06","June",19924,193969,0.102717444540107,2020-06-01,"Boulder County, CO",174045
"319","2020","M07","July",12643,187992,0.0672528618239074,2020-07-01,"Boulder County, CO",175349
"320","2020","M08","August",11735,191671,0.061224702745851,2020-08-01,"Boulder County, CO",179936
"321","2020","M09","September",11265,194964,0.0577798978272912,2020-09-01,"Boulder County, CO",183699
"322","2020","M10","October",10707,193588,0.055308180259107,2020-10-01,"Boulder County, CO",182881
"323","2020","M11","November",10653,194912,0.05465543424725,2020-11-01,"Boulder County, CO",184259
"324","2020","M12","December",11220,194211,0.0577722168157313,2020-12-01,"Boulder County, CO",182991
"325","2021","M01","January",11551,193636,0.059653163667913,2021-01-01,"Boulder County, CO",182085
"326","2021","M02","February",11031,195900,0.0563093415007657,2021-02-01,"Boulder County, CO",184869
"327","2021","M03","March",10842,195450,0.0554719877206447,2021-03-01,"Boulder County, CO",184608
"328","2021","M04","April",10357,196269,0.0527694134071096,2021-04-01,"Boulder County, CO",185912
"329","2021","M05","May",9458,196689,0.0480860648028105,2021-05-01,"Boulder County, CO",187231
"330","2021","M06","June",10743,195242,0.0550240214707901,2021-06-01,"Boulder County, CO",184499
"331","2021","M07","July",9624,195449,0.0492404668225471,2021-07-01,"Boulder County, CO",185825
"332","2021","M08","August",8667,196196,0.0441752125425595,2021-08-01,"Boulder County, CO",187529
"333","2021","M09","September",7295,199077,0.0366441125795546,2021-09-01,"Boulder County, CO",191782
"334","2021","M10","October",6991,199189,0.0350973196311041,2021-10-01,"Boulder County, CO",192198
"335","2021","M11","November",6977,200830,0.0347408255738684,2021-11-01,"Boulder County, CO",193853
"336","2021","M12","December",6485,199627,0.032485585617176,2021-12-01,"Boulder County, CO",193142
"337","2020","M01","January",35692,1051410,0.0339467952558945,2020-01-01,"Broward County, FL",1015718
"338","2020","M02","February",34567,1056657,0.0327135484835666,2020-02-01,"Broward County, FL",1022090
"339","2020","M03","March",63142,1068549,0.0590913472381706,2020-03-01,"Broward County, FL",1005407
"340","2020","M04","April",161145,985109,0.163580882927676,2020-04-01,"Broward County, FL",823964
"341","2020","M05","May",177811,1023461,0.173735003092448,2020-05-01,"Broward County, FL",845650
"342","2020","M06","June",142621,1021973,0.139554567488574,2020-06-01,"Broward County, FL",879352
"343","2020","M07","July",140820,1034280,0.136152685926442,2020-07-01,"Broward County, FL",893460
"344","2020","M08","August",96088,1007873,0.0953374085822321,2020-08-01,"Broward County, FL",911785
"345","2020","M09","September",78058,1008017,0.077437186079203,2020-09-01,"Broward County, FL",929959
"346","2020","M10","October",60774,1004367,0.0605097539046982,2020-10-01,"Broward County, FL",943593
"347","2020","M11","November",51503,995849,0.0517176800900538,2020-11-01,"Broward County, FL",944346
"348","2020","M12","December",41249,989486,0.0416873002750923,2020-12-01,"Broward County, FL",948237
"349","2021","M01","January",59226,1012747,0.0584805484489216,2021-01-01,"Broward County, FL",953521
"350","2021","M02","February",52174,1017917,0.0512556524746124,2021-02-01,"Broward County, FL",965743
"351","2021","M03","March",54309,1024050,0.0530335432840193,2021-03-01,"Broward County, FL",969741
"352","2021","M04","April",55835,1030559,0.0541793337402322,2021-04-01,"Broward County, FL",974724
"353","2021","M05","May",54537,1043981,0.0522394564652039,2021-05-01,"Broward County, FL",989444
"354","2021","M06","June",60890,1056520,0.0576326051565517,2021-06-01,"Broward County, FL",995630
"355","2021","M07","July",54473,1059149,0.0514309129310418,2021-07-01,"Broward County, FL",1004676
"356","2021","M08","August",51948,1058060,0.0490974046840444,2021-08-01,"Broward County, FL",1006112
"357","2021","M09","September",45855,1051490,0.0436095445510656,2021-09-01,"Broward County, FL",1005635
"358","2021","M10","October",44766,1061846,0.0421586557749429,2021-10-01,"Broward County, FL",1017080
"359","2021","M11","November",40258,1056540,0.0381036212542828,2021-11-01,"Broward County, FL",1016282
"360","2021","M12","December",38152,1055251,0.0361544315049216,2021-12-01,"Broward County, FL",1017099
"361","2020","M01","January",6089,107827,0.0564700863420108,2020-01-01,"Buffalo, NY",101738
"362","2020","M02","February",5950,106920,0.0556490834268612,2020-02-01,"Buffalo, NY",100970
"363","2020","M03","March",6483,107175,0.0604898530440868,2020-03-01,"Buffalo, NY",100692
"364","2020","M04","April",25748,107273,0.240023118585292,2020-04-01,"Buffalo, NY",81525
"365","2020","M05","May",21100,109224,0.193180985863913,2020-05-01,"Buffalo, NY",88124
"366","2020","M06","June",21315,114404,0.186313415614839,2020-06-01,"Buffalo, NY",93089
"367","2020","M07","July",22601,117689,0.19204003772655,2020-07-01,"Buffalo, NY",95088
"368","2020","M08","August",17838,115003,0.155108997156596,2020-08-01,"Buffalo, NY",97165
"369","2020","M09","September",12266,110133,0.111374429099362,2020-09-01,"Buffalo, NY",97867
"370","2020","M10","October",11396,110187,0.103424178895877,2020-10-01,"Buffalo, NY",98791
"371","2020","M11","November",11135,109968,0.101256729230322,2020-11-01,"Buffalo, NY",98833
"372","2020","M12","December",12269,110602,0.110929277951574,2020-12-01,"Buffalo, NY",98333
"373","2021","M01","January",11974,109530,0.109321647037341,2021-01-01,"Buffalo, NY",97556
"374","2021","M02","February",11366,108519,0.104737419253771,2021-02-01,"Buffalo, NY",97153
"375","2021","M03","March",10275,108686,0.0945383950094768,2021-03-01,"Buffalo, NY",98411
"376","2021","M04","April",8968,108604,0.0825752274317705,2021-04-01,"Buffalo, NY",99636
"377","2021","M05","May",8415,109030,0.0771805924974778,2021-05-01,"Buffalo, NY",100615
"378","2021","M06","June",8948,110325,0.0811058237026966,2021-06-01,"Buffalo, NY",101377
"379","2021","M07","July",9641,111375,0.0865634118967452,2021-07-01,"Buffalo, NY",101734
"380","2021","M08","August",9211,110562,0.0833107215860784,2021-08-01,"Buffalo, NY",101351
"381","2021","M09","September",7817,108504,0.0720434269704343,2021-09-01,"Buffalo, NY",100687
"382","2021","M10","October",7150,107094,0.0667637776159262,2021-10-01,"Buffalo, NY",99944
"383","2021","M11","November",6238,105857,0.0589285545594528,2021-11-01,"Buffalo, NY",99619
"384","2021","M12","December",4297,104205,0.0412360251427475,2021-12-01,"Buffalo, NY",99908
"385","2020","M01","January",4029,140318,0.0287133511024958,2020-01-01,"Buncombe County, NC",136289
"386","2020","M02","February",3806,141648,0.0268694227945329,2020-02-01,"Buncombe County, NC",137842
"387","2020","M03","March",4308,134776,0.0319641479195109,2020-03-01,"Buncombe County, NC",130468
"388","2020","M04","April",24020,129904,0.18490577657347,2020-04-01,"Buncombe County, NC",105884
"389","2020","M05","May",24913,134742,0.184894093897968,2020-05-01,"Buncombe County, NC",109829
"390","2020","M06","June",15077,133242,0.11315501118266,2020-06-01,"Buncombe County, NC",118165
"391","2020","M07","July",14567,136709,0.106554798879372,2020-07-01,"Buncombe County, NC",122142
"392","2020","M08","August",10287,134962,0.0762214549280538,2020-08-01,"Buncombe County, NC",124675
"393","2020","M09","September",10428,138179,0.0754673286099914,2020-09-01,"Buncombe County, NC",127751
"394","2020","M10","October",8907,138386,0.0643634471695114,2020-10-01,"Buncombe County, NC",129479
"395","2020","M11","November",8263,137951,0.0598980797529558,2020-11-01,"Buncombe County, NC",129688
"396","2020","M12","December",7786,136944,0.0568553569342213,2020-12-01,"Buncombe County, NC",129158
"397","2021","M01","January",7650,135909,0.0562876630686709,2021-01-01,"Buncombe County, NC",128259
"398","2021","M02","February",7104,136434,0.0520691323277189,2021-02-01,"Buncombe County, NC",129330
"399","2021","M03","March",5756,136118,0.0422868393599671,2021-03-01,"Buncombe County, NC",130362
"400","2021","M04","April",5352,135316,0.0395518637855095,2021-04-01,"Buncombe County, NC",129964
"401","2021","M05","May",5460,133531,0.0408893814919382,2021-05-01,"Buncombe County, NC",128071
"402","2021","M06","June",6064,135894,0.0446230149969829,2021-06-01,"Buncombe County, NC",129830
"403","2021","M07","July",5472,136555,0.0400717659551097,2021-07-01,"Buncombe County, NC",131083
"404","2021","M08","August",5148,136392,0.0377441492169629,2021-08-01,"Buncombe County, NC",131244
"405","2021","M09","September",4400,137478,0.0320051208193311,2021-09-01,"Buncombe County, NC",133078
"406","2021","M10","October",4198,137861,0.0304509614756893,2021-10-01,"Buncombe County, NC",133663
"407","2021","M11","November",3841,137410,0.0279528418601266,2021-11-01,"Buncombe County, NC",133569
"408","2021","M12","December",3576,138033,0.0259068483623481,2021-12-01,"Buncombe County, NC",134457
"409","2020","M01","January",11587,257931,0.0449228669682977,2020-01-01,"Camden County, NJ",246344
"410","2020","M02","February",11138,259508,0.0429196787767622,2020-02-01,"Camden County, NJ",248370
"411","2020","M03","March",11590,258247,0.0448795145732574,2020-03-01,"Camden County, NJ",246657
"412","2020","M04","April",43022,254631,0.168958217970318,2020-04-01,"Camden County, NJ",211609
"413","2020","M05","May",43154,255575,0.168850630930255,2020-05-01,"Camden County, NJ",212421
"414","2020","M06","June",41871,257868,0.162373772627856,2020-06-01,"Camden County, NJ",215997
"415","2020","M07","July",36343,265528,0.136870687837064,2020-07-01,"Camden County, NJ",229185
"416","2020","M08","August",28584,258789,0.110452917241459,2020-08-01,"Camden County, NJ",230205
"417","2020","M09","September",19147,247491,0.0773644294135948,2020-09-01,"Camden County, NJ",228344
"418","2020","M10","October",18148,249472,0.0727456387891226,2020-10-01,"Camden County, NJ",231324
"419","2020","M11","November",25628,257091,0.0996845474948559,2020-11-01,"Camden County, NJ",231463
"420","2020","M12","December",18914,250443,0.0755221747064202,2020-12-01,"Camden County, NJ",231529
"421","2021","M01","January",20736,250086,0.0829154770758859,2021-01-01,"Camden County, NJ",229350
"422","2021","M02","February",21703,252220,0.0860478946951074,2021-02-01,"Camden County, NJ",230517
"423","2021","M03","March",20722,255148,0.0812156081960274,2021-03-01,"Camden County, NJ",234426
"424","2021","M04","April",18732,252160,0.0742861675126903,2021-04-01,"Camden County, NJ",233428
"425","2021","M05","May",18761,252365,0.0743407366314663,2021-05-01,"Camden County, NJ",233604
"426","2021","M06","June",22490,256054,0.0878330352191335,2021-06-01,"Camden County, NJ",233564
"427","2021","M07","July",21375,256998,0.083171853477459,2021-07-01,"Camden County, NJ",235623
"428","2021","M08","August",19532,255196,0.0765372498001536,2021-08-01,"Camden County, NJ",235664
"429","2021","M09","September",17018,252954,0.067277054326083,2021-09-01,"Camden County, NJ",235936
"430","2021","M10","October",14954,256660,0.0582638510091171,2021-10-01,"Camden County, NJ",241706
"431","2021","M11","November",14309,257243,0.0556244484786758,2021-11-01,"Camden County, NJ",242934
"432","2021","M12","December",13672,259284,0.0527298252109656,2021-12-01,"Camden County, NJ",245612
"433","2020","M01","January",10546,170517,0.0618472058504431,2020-01-01,"Cameron County, TX",159971
"434","2020","M02","February",9653,170264,0.0566943100126862,2020-02-01,"Cameron County, TX",160611
"435","2020","M03","March",13021,168585,0.0772370021057627,2020-03-01,"Cameron County, TX",155564
"436","2020","M04","April",26248,162372,0.161653487054418,2020-04-01,"Cameron County, TX",136124
"437","2020","M05","May",23561,165134,0.142678067508811,2020-05-01,"Cameron County, TX",141573
"438","2020","M06","June",21378,172060,0.124247355573637,2020-06-01,"Cameron County, TX",150682
"439","2020","M07","July",21353,170587,0.125173665050678,2020-07-01,"Cameron County, TX",149234
"440","2020","M08","August",15369,171497,0.0896167279894109,2020-08-01,"Cameron County, TX",156128
"441","2020","M09","September",17406,168933,0.103034931008151,2020-09-01,"Cameron County, TX",151527
"442","2020","M10","October",15898,170201,0.0934072067731682,2020-10-01,"Cameron County, TX",154303
"443","2020","M11","November",16088,168881,0.0952623444910914,2020-11-01,"Cameron County, TX",152793
"444","2020","M12","December",16112,169862,0.0948534692868328,2020-12-01,"Cameron County, TX",153750
"445","2021","M01","January",17841,169824,0.105055822498587,2021-01-01,"Cameron County, TX",151983
"446","2021","M02","February",18525,170341,0.108752443627782,2021-02-01,"Cameron County, TX",151816
"447","2021","M03","March",17049,170871,0.0997770247730744,2021-03-01,"Cameron County, TX",153822
"448","2021","M04","April",15833,170138,0.0930597514958446,2021-04-01,"Cameron County, TX",154305
"449","2021","M05","May",14803,169186,0.0874954192427269,2021-05-01,"Cameron County, TX",154383
"450","2021","M06","June",16650,171080,0.0973228898760814,2021-06-01,"Cameron County, TX",154430
"451","2021","M07","July",15082,171012,0.0881926414520618,2021-07-01,"Cameron County, TX",155930
"452","2021","M08","August",13333,170238,0.0783197640949729,2021-08-01,"Cameron County, TX",156905
"453","2021","M09","September",12347,170210,0.0725398037718113,2021-09-01,"Cameron County, TX",157863
"454","2021","M10","October",11941,169455,0.0704670856569591,2021-10-01,"Cameron County, TX",157514
"455","2021","M11","November",11679,170542,0.0684816643407489,2021-11-01,"Cameron County, TX",158863
"456","2021","M12","December",11566,170564,0.0678103233976689,2021-12-01,"Cameron County, TX",158998
"457","2020","M01","January",5654,155026,0.0364713015881207,2020-01-01,"Chandler, AZ",149372
"458","2020","M02","February",5394,155602,0.0346653641984036,2020-02-01,"Chandler, AZ",150208
"459","2020","M03","March",6285,154768,0.0406091698542334,2020-03-01,"Chandler, AZ",148483
"460","2020","M04","April",19640,152146,0.129086535301618,2020-04-01,"Chandler, AZ",132506
"461","2020","M05","May",14403,155976,0.0923411294045238,2020-05-01,"Chandler, AZ",141573
"462","2020","M06","June",14110,153357,0.092007537966966,2020-06-01,"Chandler, AZ",139247
"463","2020","M07","July",14076,155363,0.0906007221796696,2020-07-01,"Chandler, AZ",141287
"464","2020","M08","August",8771,151992,0.0577069845781357,2020-08-01,"Chandler, AZ",143221
"465","2020","M09","September",8760,153373,0.0571156592099,2020-09-01,"Chandler, AZ",144613
"466","2020","M10","October",8065,153385,0.0525801088763569,2020-10-01,"Chandler, AZ",145320
"467","2020","M11","November",8240,154516,0.0533278107121593,2020-11-01,"Chandler, AZ",146276
"468","2020","M12","December",8625,154489,0.0558292176141991,2020-12-01,"Chandler, AZ",145864
"469","2021","M01","January",9086,154881,0.058664393954068,2021-01-01,"Chandler, AZ",145795
"470","2021","M02","February",9023,155448,0.0580451340641243,2021-02-01,"Chandler, AZ",146425
"471","2021","M03","March",8192,155733,0.052602852317749,2021-03-01,"Chandler, AZ",147541
"472","2021","M04","April",8091,156384,0.05173802946593,2021-04-01,"Chandler, AZ",148293
"473","2021","M05","May",8336,157366,0.0529720524128465,2021-05-01,"Chandler, AZ",149030
"474","2021","M06","June",8917,158639,0.0562093810475356,2021-06-01,"Chandler, AZ",149722
"475","2021","M07","July",7739,158673,0.0487732632520971,2021-07-01,"Chandler, AZ",150934
"476","2021","M08","August",6416,157911,0.0406304817270488,2021-08-01,"Chandler, AZ",151495
"477","2021","M09","September",4920,158900,0.0309628697293896,2021-09-01,"Chandler, AZ",153980
"478","2021","M10","October",4160,159132,0.0261418193700827,2021-10-01,"Chandler, AZ",154972
"479","2021","M11","November",3731,160021,0.0233156898157117,2021-11-01,"Chandler, AZ",156290
"480","2021","M12","December",3297,159731,0.0206409526015614,2021-12-01,"Chandler, AZ",156434
"481","2020","M01","January",5095,210744,0.0241762517556846,2020-01-01,"Charleston County, SC",205649
"482","2020","M02","February",5041,211903,0.0237891865617759,2020-02-01,"Charleston County, SC",206862
"483","2020","M03","March",5221,209943,0.0248686548253574,2020-03-01,"Charleston County, SC",204722
"484","2020","M04","April",24612,206063,0.119439200632816,2020-04-01,"Charleston County, SC",181451
"485","2020","M05","May",25849,210619,0.1227287186816,2020-05-01,"Charleston County, SC",184770
"486","2020","M06","June",17912,215364,0.0831708177782731,2020-06-01,"Charleston County, SC",197452
"487","2020","M07","July",18577,219494,0.0846355709039883,2020-07-01,"Charleston County, SC",200917
"488","2020","M08","August",12843,214677,0.0598247599882614,2020-08-01,"Charleston County, SC",201834
"489","2020","M09","September",11701,213832,0.0547205282651801,2020-09-01,"Charleston County, SC",202131
"490","2020","M10","October",11025,214738,0.0513416349225568,2020-10-01,"Charleston County, SC",203713
"491","2020","M11","November",11009,206950,0.0531964242570669,2020-11-01,"Charleston County, SC",195941
"492","2020","M12","December",11757,208943,0.0562689345898164,2020-12-01,"Charleston County, SC",197186
"493","2021","M01","January",10696,208849,0.0512140350205172,2021-01-01,"Charleston County, SC",198153
"494","2021","M02","February",10153,211808,0.0479349221936848,2021-02-01,"Charleston County, SC",201655
"495","2021","M03","March",9320,212551,0.0438482999374268,2021-03-01,"Charleston County, SC",203231
"496","2021","M04","April",8314,211721,0.0392686601706963,2021-04-01,"Charleston County, SC",203407
"497","2021","M05","May",6850,213096,0.0321451364643166,2021-05-01,"Charleston County, SC",206246
"498","2021","M06","June",8577,218030,0.039338623125258,2021-06-01,"Charleston County, SC",209453
"499","2021","M07","July",8457,219143,0.0385912395102741,2021-07-01,"Charleston County, SC",210686
"500","2021","M08","August",8289,216061,0.0383641656754343,2021-08-01,"Charleston County, SC",207772
"501","2021","M09","September",6102,212910,0.0286599971819078,2021-09-01,"Charleston County, SC",206808
"502","2021","M10","October",5759,213710,0.0269477329090824,2021-10-01,"Charleston County, SC",207951
"503","2021","M11","November",5597,214057,0.0261472411553932,2021-11-01,"Charleston County, SC",208460
"504","2021","M12","December",6154,214076,0.0287468002017975,2021-12-01,"Charleston County, SC",207922
"505","2020","M01","January",3868,138603,0.0279070438590795,2020-01-01,"Cherokee County, GA",134735
"506","2020","M02","February",3757,139450,0.0269415561133023,2020-02-01,"Cherokee County, GA",135693
"507","2020","M03","March",3935,138205,0.0284721970985131,2020-03-01,"Cherokee County, GA",134270
"508","2020","M04","April",13922,129690,0.107348292081117,2020-04-01,"Cherokee County, GA",115768
"509","2020","M05","May",9875,130638,0.0755905632358119,2020-05-01,"Cherokee County, GA",120763
"510","2020","M06","June",8617,130099,0.0662341755124943,2020-06-01,"Cherokee County, GA",121482
"511","2020","M07","July",7474,129821,0.05757157932846,2020-07-01,"Cherokee County, GA",122347
"512","2020","M08","August",6098,128649,0.0474002907134917,2020-08-01,"Cherokee County, GA",122551
"513","2020","M09","September",5430,128740,0.0421780332453006,2020-09-01,"Cherokee County, GA",123310
"514","2020","M10","October",4823,133859,0.0360304499510679,2020-10-01,"Cherokee County, GA",129036
"515","2020","M11","November",4672,134177,0.03481967848439,2020-11-01,"Cherokee County, GA",129505
"516","2020","M12","December",5095,134611,0.037849804250767,2020-12-01,"Cherokee County, GA",129516
"517","2021","M01","January",4358,133490,0.0326466401977676,2021-01-01,"Cherokee County, GA",129132
"518","2021","M02","February",3945,135193,0.0291805049077985,2021-02-01,"Cherokee County, GA",131248
"519","2021","M03","March",3595,136139,0.0264068341915248,2021-03-01,"Cherokee County, GA",132544
"520","2021","M04","April",3434,136623,0.0251348601626373,2021-04-01,"Cherokee County, GA",133189
"521","2021","M05","May",3646,136159,0.0267775174612034,2021-05-01,"Cherokee County, GA",132513
"522","2021","M06","June",4106,136987,0.0299736471343996,2021-06-01,"Cherokee County, GA",132881
"523","2021","M07","July",2818,137655,0.0204714685263884,2021-07-01,"Cherokee County, GA",134837
"524","2021","M08","August",2996,137044,0.0218615918974928,2021-08-01,"Cherokee County, GA",134048
"525","2021","M09","September",2344,137692,0.0170235017284955,2021-09-01,"Cherokee County, GA",135348
"526","2021","M10","October",2401,138517,0.0173336124807785,2021-10-01,"Cherokee County, GA",136116
"527","2021","M11","November",2163,139110,0.015548846236791,2021-11-01,"Cherokee County, GA",136947
"528","2021","M12","December",2502,139630,0.017918785361312,2021-12-01,"Cherokee County, GA",137128
"529","2020","M01","January",5070,191450,0.0264821102115435,2020-01-01,"Chesterfield County, VA",186380
"530","2020","M02","February",4566,191822,0.0238033176590798,2020-02-01,"Chesterfield County, VA",187256
"531","2020","M03","March",5091,191085,0.0266425936101735,2020-03-01,"Chesterfield County, VA",185994
"532","2020","M04","April",20078,187605,0.107022733935663,2020-04-01,"Chesterfield County, VA",167527
"533","2020","M05","May",15062,182830,0.0823825411584532,2020-05-01,"Chesterfield County, VA",167768
"534","2020","M06","June",15743,186266,0.084518913811431,2020-06-01,"Chesterfield County, VA",170523
"535","2020","M07","July",14136,187423,0.0754229737012,2020-07-01,"Chesterfield County, VA",173287
"536","2020","M08","August",12344,188492,0.0654881904802326,2020-08-01,"Chesterfield County, VA",176148
"537","2020","M09","September",11072,183303,0.0604027211775039,2020-09-01,"Chesterfield County, VA",172231
"538","2020","M10","October",9641,181516,0.0531137750942066,2020-10-01,"Chesterfield County, VA",171875
"539","2020","M11","November",9219,181004,0.0509325760756668,2020-11-01,"Chesterfield County, VA",171785
"540","2020","M12","December",9625,180246,0.0533992432564384,2020-12-01,"Chesterfield County, VA",170621
"541","2021","M01","January",9358,178708,0.0523647514381001,2021-01-01,"Chesterfield County, VA",169350
"542","2021","M02","February",8890,179062,0.0496476080910523,2021-02-01,"Chesterfield County, VA",170172
"543","2021","M03","March",8643,179836,0.0480604550812963,2021-03-01,"Chesterfield County, VA",171193
"544","2021","M04","April",6563,177269,0.0370228297107785,2021-04-01,"Chesterfield County, VA",170706
"545","2021","M05","May",6942,178032,0.0389929900242653,2021-05-01,"Chesterfield County, VA",171090
"546","2021","M06","June",7739,180282,0.042927191843889,2021-06-01,"Chesterfield County, VA",172543
"547","2021","M07","July",6887,182844,0.0376659884929229,2021-07-01,"Chesterfield County, VA",175957
"548","2021","M08","August",6403,179884,0.035595161326188,2021-08-01,"Chesterfield County, VA",173481
"549","2021","M09","September",5573,176688,0.0315414742370733,2021-09-01,"Chesterfield County, VA",171115
"550","2021","M10","October",5287,177928,0.0297142664448541,2021-10-01,"Chesterfield County, VA",172641
"551","2021","M11","November",4612,177147,0.0260348749908268,2021-11-01,"Chesterfield County, VA",172535
"552","2021","M12","December",4894,177894,0.0275107648374875,2021-12-01,"Chesterfield County, VA",173000
"553","2020","M01","January",4798,124233,0.0386209783229899,2020-01-01,"Chula Vista, CA",119435
"554","2020","M02","February",4410,124773,0.0353441850400327,2020-02-01,"Chula Vista, CA",120363
"555","2020","M03","March",5233,123980,0.0422084207130182,2020-03-01,"Chula Vista, CA",118747
"556","2020","M04","April",20473,120234,0.170276294558943,2020-04-01,"Chula Vista, CA",99761
"557","2020","M05","May",20773,120564,0.1722985302412,2020-05-01,"Chula Vista, CA",99791
"558","2020","M06","June",18556,122846,0.151050909268515,2020-06-01,"Chula Vista, CA",104290
"559","2020","M07","July",17079,122604,0.139302143486346,2020-07-01,"Chula Vista, CA",105525
"560","2020","M08","August",14863,121026,0.122808322178705,2020-08-01,"Chula Vista, CA",106163
"561","2020","M09","September",13248,120429,0.110006725954712,2020-09-01,"Chula Vista, CA",107181
"562","2020","M10","October",12282,123010,0.0998455410129258,2020-10-01,"Chula Vista, CA",110728
"563","2020","M11","November",9959,121276,0.0821184735644315,2020-11-01,"Chula Vista, CA",111317
"564","2020","M12","December",10972,121728,0.0901353838065194,2020-12-01,"Chula Vista, CA",110756
"565","2021","M01","January",10809,120348,0.0898145378402632,2021-01-01,"Chula Vista, CA",109539
"566","2021","M02","February",10288,122971,0.0836620016101357,2021-02-01,"Chula Vista, CA",112683
"567","2021","M03","March",9480,121577,0.077975274928646,2021-03-01,"Chula Vista, CA",112097
"568","2021","M04","April",9340,120222,0.0776896075593485,2021-04-01,"Chula Vista, CA",110882
"569","2021","M05","May",8940,120558,0.0741551784203454,2021-05-01,"Chula Vista, CA",111618
"570","2021","M06","June",9865,121240,0.0813675354668426,2021-06-01,"Chula Vista, CA",111375
"571","2021","M07","July",9931,122766,0.080893732792467,2021-07-01,"Chula Vista, CA",112835
"572","2021","M08","August",9291,121789,0.0762876778691015,2021-08-01,"Chula Vista, CA",112498
"573","2021","M09","September",8052,121878,0.0660660660660661,2021-09-01,"Chula Vista, CA",113826
"574","2021","M10","October",7796,123236,0.0632607354993671,2021-10-01,"Chula Vista, CA",115440
"575","2021","M11","November",6727,123578,0.0544352554661833,2021-11-01,"Chula Vista, CA",116851
"576","2021","M12","December",6084,122819,0.049536309528656,2021-12-01,"Chula Vista, CA",116735
"577","2020","M01","January",7221,148373,0.0486678843185755,2020-01-01,"Cincinnati, OH",141152
"578","2020","M02","February",6671,148727,0.0448539942310408,2020-02-01,"Cincinnati, OH",142056
"579","2020","M03","March",8085,149155,0.054205356843552,2020-03-01,"Cincinnati, OH",141070
"580","2020","M04","April",20528,139457,0.147199495184896,2020-04-01,"Cincinnati, OH",118929
"581","2020","M05","May",23045,150455,0.153168721544648,2020-05-01,"Cincinnati, OH",127410
"582","2020","M06","June",18305,150489,0.121636797373894,2020-06-01,"Cincinnati, OH",132184
"583","2020","M07","July",19207,154069,0.124664922859238,2020-07-01,"Cincinnati, OH",134862
"584","2020","M08","August",18339,155999,0.117558445887474,2020-08-01,"Cincinnati, OH",137660
"585","2020","M09","September",14319,151365,0.0945991477554256,2020-09-01,"Cincinnati, OH",137046
"586","2020","M10","October",9006,147859,0.0609093798821851,2020-10-01,"Cincinnati, OH",138853
"587","2020","M11","November",8381,147096,0.0569763963669984,2020-11-01,"Cincinnati, OH",138715
"588","2020","M12","December",8497,146500,0.058,2020-12-01,"Cincinnati, OH",138003
"589","2021","M01","January",10003,146688,0.0681923538394415,2021-01-01,"Cincinnati, OH",136685
"590","2021","M02","February",9183,146962,0.0624855404798519,2021-02-01,"Cincinnati, OH",137779
"591","2021","M03","March",7247,146796,0.0493678301861086,2021-03-01,"Cincinnati, OH",139549
"592","2021","M04","April",8254,149261,0.0552991069334923,2021-04-01,"Cincinnati, OH",141007
"593","2021","M05","May",8177,142529,0.0573707806832294,2021-05-01,"Cincinnati, OH",134352
"594","2021","M06","June",10070,146020,0.0689631557320915,2021-06-01,"Cincinnati, OH",135950
"595","2021","M07","July",9899,147446,0.0671364431724157,2021-07-01,"Cincinnati, OH",137547
"596","2021","M08","August",8593,148937,0.0576955356963011,2021-08-01,"Cincinnati, OH",140344
"597","2021","M09","September",7351,147826,0.0497273821925778,2021-09-01,"Cincinnati, OH",140475
"598","2021","M10","October",6333,148222,0.0427264508642442,2021-10-01,"Cincinnati, OH",141889
"599","2021","M11","November",5384,147525,0.0364955092357228,2021-11-01,"Cincinnati, OH",142141
"600","2021","M12","December",4978,147528,0.0337427471395261,2021-12-01,"Cincinnati, OH",142550
"601","2020","M01","January",7099,218854,0.0324371498807424,2020-01-01,"Clackamas County, OR",211755
"602","2020","M02","February",7006,220408,0.0317865050270408,2020-02-01,"Clackamas County, OR",213402
"603","2020","M03","March",8505,219206,0.0387991204620311,2020-03-01,"Clackamas County, OR",210701
"604","2020","M04","April",25856,211088,0.122489198817555,2020-04-01,"Clackamas County, OR",185232
"605","2020","M05","May",24077,217751,0.110571248811716,2020-05-01,"Clackamas County, OR",193674
"606","2020","M06","June",22031,219726,0.1002657855693,2020-06-01,"Clackamas County, OR",197695
"607","2020","M07","July",20376,211337,0.0964147309746992,2020-07-01,"Clackamas County, OR",190961
"608","2020","M08","August",17727,217770,0.0814023970243835,2020-08-01,"Clackamas County, OR",200043
"609","2020","M09","September",16080,218197,0.0736948720651521,2020-09-01,"Clackamas County, OR",202117
"610","2020","M10","October",14279,220181,0.0648511906113607,2020-10-01,"Clackamas County, OR",205902
"611","2020","M11","November",13336,221355,0.0602471143638047,2020-11-01,"Clackamas County, OR",208019
"612","2020","M12","December",13186,220603,0.0597725325584874,2020-12-01,"Clackamas County, OR",207417
"613","2021","M01","January",14577,219978,0.066265717480839,2021-01-01,"Clackamas County, OR",205401
"614","2021","M02","February",13762,221203,0.0622143460983802,2021-02-01,"Clackamas County, OR",207441
"615","2021","M03","March",13900,222975,0.0623388272227828,2021-03-01,"Clackamas County, OR",209075
"616","2021","M04","April",12320,222957,0.0552572917647798,2021-04-01,"Clackamas County, OR",210637
"617","2021","M05","May",11113,223397,0.0497455203068976,2021-05-01,"Clackamas County, OR",212284
"618","2021","M06","June",10873,223760,0.0485922416875223,2021-06-01,"Clackamas County, OR",212887
"619","2021","M07","July",10094,226296,0.0446052957188815,2021-07-01,"Clackamas County, OR",216202
"620","2021","M08","August",9400,225695,0.0416491282482997,2021-08-01,"Clackamas County, OR",216295
"621","2021","M09","September",8692,225320,0.0385762471152139,2021-09-01,"Clackamas County, OR",216628
"622","2021","M10","October",7193,225844,0.0318494181824622,2021-10-01,"Clackamas County, OR",218651
"623","2021","M11","November",7096,227014,0.031257984089087,2021-11-01,"Clackamas County, OR",219918
"624","2021","M12","December",7418,226954,0.0326850374965852,2021-12-01,"Clackamas County, OR",219536
"625","2020","M01","January",11956,249761,0.0478697634939002,2020-01-01,"Clark County, WA",237805
"626","2020","M02","February",12234,251505,0.0486431681278702,2020-02-01,"Clark County, WA",239271
"627","2020","M03","March",12911,248483,0.0519592889654423,2020-03-01,"Clark County, WA",235572
"628","2020","M04","April",36416,245417,0.148384178765122,2020-04-01,"Clark County, WA",209001
"629","2020","M05","May",30395,241194,0.126018889358773,2020-05-01,"Clark County, WA",210799
"630","2020","M06","June",26518,236982,0.111898794001232,2020-06-01,"Clark County, WA",210464
"631","2020","M07","July",29158,242028,0.120473664204142,2020-07-01,"Clark County, WA",212870
"632","2020","M08","August",22544,237346,0.0949836946904519,2020-08-01,"Clark County, WA",214802
"633","2020","M09","September",18834,234704,0.0802457563569432,2020-09-01,"Clark County, WA",215870
"634","2020","M10","October",16044,253545,0.0632787079216707,2020-10-01,"Clark County, WA",237501
"635","2020","M11","November",15830,237180,0.0667425583944683,2020-11-01,"Clark County, WA",221350
"636","2020","M12","December",15347,232788,0.065926937814664,2020-12-01,"Clark County, WA",217441
"637","2021","M01","January",14653,230492,0.0635727053433525,2021-01-01,"Clark County, WA",215839
"638","2021","M02","February",15004,232089,0.0646476136309778,2021-02-01,"Clark County, WA",217085
"639","2021","M03","March",14877,236894,0.062800239769686,2021-03-01,"Clark County, WA",222017
"640","2021","M04","April",13834,237684,0.0582033287894852,2021-04-01,"Clark County, WA",223850
"641","2021","M05","May",11867,239572,0.0495341692685289,2021-05-01,"Clark County, WA",227705
"642","2021","M06","June",11756,238895,0.0492099039326901,2021-06-01,"Clark County, WA",227139
"643","2021","M07","July",11032,241162,0.0457451837354144,2021-07-01,"Clark County, WA",230130
"644","2021","M08","August",11695,242757,0.0481757477642251,2021-08-01,"Clark County, WA",231062
"645","2021","M09","September",9736,241084,0.0403842644057673,2021-09-01,"Clark County, WA",231348
"646","2021","M10","October",9931,244095,0.0406849792089146,2021-10-01,"Clark County, WA",234164
"647","2021","M11","November",8820,249117,0.0354050506388564,2021-11-01,"Clark County, WA",240297
"648","2021","M12","December",9210,249873,0.0368587242319098,2021-12-01,"Clark County, WA",240663
"649","2020","M01","January",13281,428385,0.0310024860814454,2020-01-01,"Cobb County, GA",415104
"650","2020","M02","February",12809,430881,0.0297274653558639,2020-02-01,"Cobb County, GA",418072
"651","2020","M03","March",13988,427685,0.032706314226592,2020-03-01,"Cobb County, GA",413697
"652","2020","M04","April",45712,402321,0.11362071579659,2020-04-01,"Cobb County, GA",356609
"653","2020","M05","May",36217,408248,0.0887132331328016,2020-05-01,"Cobb County, GA",372031
"654","2020","M06","June",33444,407759,0.0820190357539625,2020-06-01,"Cobb County, GA",374315
"655","2020","M07","July",30187,407046,0.0741611513195069,2020-07-01,"Cobb County, GA",376859
"656","2020","M08","August",25252,402466,0.0627431882444728,2020-08-01,"Cobb County, GA",377214
"657","2020","M09","September",23035,402694,0.0572022428941082,2020-09-01,"Cobb County, GA",379659
"658","2020","M10","October",20033,417339,0.0480017443852599,2020-10-01,"Cobb County, GA",397306
"659","2020","M11","November",19406,418253,0.0463977544691849,2020-11-01,"Cobb County, GA",398847
"660","2020","M12","December",20071,419203,0.0478789512479634,2020-12-01,"Cobb County, GA",399132
"661","2021","M01","January",17599,415354,0.0423710858689215,2021-01-01,"Cobb County, GA",397755
"662","2021","M02","February",15877,420306,0.0377748592691991,2021-02-01,"Cobb County, GA",404429
"663","2021","M03","March",14410,422586,0.0340995678986053,2021-03-01,"Cobb County, GA",408176
"664","2021","M04","April",13688,423889,0.0322914725317241,2021-04-01,"Cobb County, GA",410201
"665","2021","M05","May",13923,422050,0.032988982348063,2021-05-01,"Cobb County, GA",408127
"666","2021","M06","June",15630,424995,0.0367769032576854,2021-06-01,"Cobb County, GA",409365
"667","2021","M07","July",11020,426054,0.0258652659052608,2021-07-01,"Cobb County, GA",415034
"668","2021","M08","August",10914,423258,0.0257856909969806,2021-08-01,"Cobb County, GA",412344
"669","2021","M09","September",8785,425304,0.0206558132535786,2021-09-01,"Cobb County, GA",416519
"670","2021","M10","October",8588,427487,0.0200894997976547,2021-10-01,"Cobb County, GA",418899
"671","2021","M11","November",7766,429515,0.0180808586428879,2021-11-01,"Cobb County, GA",421749
"672","2021","M12","December",8592,431010,0.0199345722837057,2021-12-01,"Cobb County, GA",422418
"673","2020","M01","January",6338,188531,0.0336178135160796,2020-01-01,"Collier County, FL",182193
"674","2020","M02","February",5654,188863,0.029937044312544,2020-02-01,"Collier County, FL",183209
"675","2020","M03","March",9232,189817,0.0486363181379961,2020-03-01,"Collier County, FL",180585
"676","2020","M04","April",23909,167457,0.142776951695062,2020-04-01,"Collier County, FL",143548
"677","2020","M05","May",22764,174253,0.130637636080871,2020-05-01,"Collier County, FL",151489
"678","2020","M06","June",18443,172660,0.106816865516043,2020-06-01,"Collier County, FL",154217
"679","2020","M07","July",18181,173682,0.104679817137067,2020-07-01,"Collier County, FL",155501
"680","2020","M08","August",12397,171373,0.0723392833176755,2020-08-01,"Collier County, FL",158976
"681","2020","M09","September",10092,171558,0.0588255866820551,2020-09-01,"Collier County, FL",161466
"682","2020","M10","October",7722,175044,0.0441146226091726,2020-10-01,"Collier County, FL",167322
"683","2020","M11","November",6549,177151,0.0369684619336047,2020-11-01,"Collier County, FL",170602
"684","2020","M12","December",5236,179568,0.0291588701773144,2020-12-01,"Collier County, FL",174332
"685","2021","M01","January",6891,185331,0.03718212279651,2021-01-01,"Collier County, FL",178440
"686","2021","M02","February",6684,186834,0.0357750730595074,2021-02-01,"Collier County, FL",180150
"687","2021","M03","March",7423,187651,0.0395574763790228,2021-03-01,"Collier County, FL",180228
"688","2021","M04","April",7104,189061,0.037575174150142,2021-04-01,"Collier County, FL",181957
"689","2021","M05","May",6963,188246,0.0369888337600799,2021-05-01,"Collier County, FL",181283
"690","2021","M06","June",8739,185698,0.0470602806707665,2021-06-01,"Collier County, FL",176959
"691","2021","M07","July",8162,185364,0.0440322824280874,2021-07-01,"Collier County, FL",177202
"692","2021","M08","August",7813,185910,0.0420257113657146,2021-08-01,"Collier County, FL",178097
"693","2021","M09","September",6570,184547,0.0356006870878421,2021-09-01,"Collier County, FL",177977
"694","2021","M10","October",6369,189956,0.0335288171997726,2021-10-01,"Collier County, FL",183587
"695","2021","M11","November",5623,193128,0.029115405327037,2021-11-01,"Collier County, FL",187505
"696","2021","M12","December",5300,194009,0.0273183202841105,2021-12-01,"Collier County, FL",188709
"697","2020","M01","January",17740,579198,0.0306285588002721,2020-01-01,"Collin County, TX",561458
"698","2020","M02","February",17173,582807,0.0294660153361233,2020-02-01,"Collin County, TX",565634
"699","2020","M03","March",24452,567942,0.0430536921023626,2020-03-01,"Collin County, TX",543490
"700","2020","M04","April",63563,541531,0.117376475215639,2020-04-01,"Collin County, TX",477968
"701","2020","M05","May",56905,548824,0.103685334460592,2020-05-01,"Collin County, TX",491919
"702","2020","M06","June",50076,570162,0.0878276700306229,2020-06-01,"Collin County, TX",520086
"703","2020","M07","July",43934,568748,0.077246865043921,2020-07-01,"Collin County, TX",524814
"704","2020","M08","August",31069,576523,0.053890304463135,2020-08-01,"Collin County, TX",545454
"705","2020","M09","September",35418,571633,0.0619593340482442,2020-09-01,"Collin County, TX",536215
"706","2020","M10","October",30945,581191,0.0532441142412735,2020-10-01,"Collin County, TX",550246
"707","2020","M11","November",30869,576628,0.0535336473428276,2020-11-01,"Collin County, TX",545759
"708","2020","M12","December",29922,582281,0.0513875603016413,2020-12-01,"Collin County, TX",552359
"709","2021","M01","January",32912,576608,0.0570786392141628,2021-01-01,"Collin County, TX",543696
"710","2021","M02","February",33917,575002,0.0589858817882373,2021-02-01,"Collin County, TX",541085
"711","2021","M03","March",32327,576470,0.0560775062015369,2021-03-01,"Collin County, TX",544143
"712","2021","M04","April",28457,576277,0.0493807665410905,2021-04-01,"Collin County, TX",547820
"713","2021","M05","May",26559,578490,0.0459109059793601,2021-05-01,"Collin County, TX",551931
"714","2021","M06","June",29915,583416,0.0512755906591523,2021-06-01,"Collin County, TX",553501
"715","2021","M07","July",26758,588235,0.0454886227443114,2021-07-01,"Collin County, TX",561477
"716","2021","M08","August",23600,589304,0.0400472421704248,2021-08-01,"Collin County, TX",565704
"717","2021","M09","September",22323,590323,0.0378148911697494,2021-09-01,"Collin County, TX",568000
"718","2021","M10","October",21634,595225,0.0363459196102314,2021-10-01,"Collin County, TX",573591
"719","2021","M11","November",20588,602958,0.0341449984907738,2021-11-01,"Collin County, TX",582370
"720","2021","M12","December",18908,601539,0.0314327084361945,2021-12-01,"Collin County, TX",582631
"721","2020","M01","January",7843,239198,0.03278873569177,2020-01-01,"Colorado Springs, CO",231355
"722","2020","M02","February",7835,240517,0.0325756599325619,2020-02-01,"Colorado Springs, CO",232682
"723","2020","M03","March",13362,235904,0.0566416847531199,2020-03-01,"Colorado Springs, CO",222542
"724","2020","M04","April",29525,227757,0.129633776349355,2020-04-01,"Colorado Springs, CO",198232
"725","2020","M05","May",27548,236358,0.116552010086394,2020-05-01,"Colorado Springs, CO",208810
"726","2020","M06","June",27672,243625,0.113584402257568,2020-06-01,"Colorado Springs, CO",215953
"727","2020","M07","July",17133,238416,0.0718617877994766,2020-07-01,"Colorado Springs, CO",221283
"728","2020","M08","August",16412,241959,0.0678296736223906,2020-08-01,"Colorado Springs, CO",225547
"729","2020","M09","September",16212,244146,0.0664028900739721,2020-09-01,"Colorado Springs, CO",227934
"730","2020","M10","October",15674,242795,0.0645565188739472,2020-10-01,"Colorado Springs, CO",227121
"731","2020","M11","November",16217,245526,0.0660500313612408,2020-11-01,"Colorado Springs, CO",229309
"732","2020","M12","December",18687,243833,0.0766385189863554,2020-12-01,"Colorado Springs, CO",225146
"733","2021","M01","January",17480,242843,0.0719806624032811,2021-01-01,"Colorado Springs, CO",225363
"734","2021","M02","February",17006,243752,0.0697676326758345,2021-02-01,"Colorado Springs, CO",226746
"735","2021","M03","March",16385,243277,0.0673512087044809,2021-03-01,"Colorado Springs, CO",226892
"736","2021","M04","April",15866,246462,0.0643750355024304,2021-04-01,"Colorado Springs, CO",230596
"737","2021","M05","May",14459,247655,0.0583836385294058,2021-05-01,"Colorado Springs, CO",233196
"738","2021","M06","June",15928,247778,0.0642833504185198,2021-06-01,"Colorado Springs, CO",231850
"739","2021","M07","July",15504,248662,0.0623496955706944,2021-07-01,"Colorado Springs, CO",233158
"740","2021","M08","August",13814,249029,0.0554714511161351,2021-08-01,"Colorado Springs, CO",235215
"741","2021","M09","September",12233,250366,0.0488604682744462,2021-09-01,"Colorado Springs, CO",238133
"742","2021","M10","October",11584,250303,0.0462799087505943,2021-10-01,"Colorado Springs, CO",238719
"743","2021","M11","November",11357,250296,0.0453742768562023,2021-11-01,"Colorado Springs, CO",238939
"744","2021","M12","December",10625,249831,0.0425287494346178,2021-12-01,"Colorado Springs, CO",239206
"745","2020","M01","January",20322,480440,0.0422987261676796,2020-01-01,"Columbus, OH",460118
"746","2020","M02","February",18913,482169,0.039224836105183,2020-02-01,"Columbus, OH",463256
"747","2020","M03","March",22822,479812,0.0475644627479096,2020-03-01,"Columbus, OH",456990
"748","2020","M04","April",64768,455594,0.1421616614793,2020-04-01,"Columbus, OH",390826
"749","2020","M05","May",67246,490020,0.137231133423126,2020-05-01,"Columbus, OH",422774
"750","2020","M06","June",50800,484454,0.104860316975399,2020-06-01,"Columbus, OH",433654
"751","2020","M07","July",52790,495925,0.106447547512225,2020-07-01,"Columbus, OH",443135
"752","2020","M08","August",50005,501578,0.0996953614392976,2020-08-01,"Columbus, OH",451573
"753","2020","M09","September",39692,488222,0.0812990811557038,2020-09-01,"Columbus, OH",448530
"754","2020","M10","October",24856,481534,0.0516183696270668,2020-10-01,"Columbus, OH",456678
"755","2020","M11","November",23626,484720,0.0487415415084998,2020-11-01,"Columbus, OH",461094
"756","2020","M12","December",23516,480615,0.0489289764156341,2020-12-01,"Columbus, OH",457099
"757","2021","M01","January",28574,482505,0.059220111708687,2021-01-01,"Columbus, OH",453931
"758","2021","M02","February",28754,486183,0.059142339407178,2021-02-01,"Columbus, OH",457429
"759","2021","M03","March",27761,488418,0.0568386095516545,2021-03-01,"Columbus, OH",460657
"760","2021","M04","April",25621,486030,0.0527148529926136,2021-04-01,"Columbus, OH",460409
"761","2021","M05","May",25076,461669,0.0543159709662117,2021-05-01,"Columbus, OH",436593
"762","2021","M06","June",29822,471803,0.063208584939053,2021-06-01,"Columbus, OH",441981
"763","2021","M07","July",28751,477384,0.060226149179696,2021-07-01,"Columbus, OH",448633
"764","2021","M08","August",24672,479166,0.0514894629418615,2021-08-01,"Columbus, OH",454494
"765","2021","M09","September",21023,475280,0.044232873253661,2021-09-01,"Columbus, OH",454257
"766","2021","M10","October",18261,478981,0.0381246855303237,2021-10-01,"Columbus, OH",460720
"767","2021","M11","November",15939,480064,0.0332018230902546,2021-11-01,"Columbus, OH",464125
"768","2021","M12","December",14262,478019,0.0298356341484334,2021-12-01,"Columbus, OH",463757
"769","2020","M01","January",18373,557538,0.032953807632843,2020-01-01,"Contra Costa County, CA",539165
"770","2020","M02","February",17320,560042,0.0309262519596745,2020-02-01,"Contra Costa County, CA",542722
"771","2020","M03","March",20299,556452,0.0364793369419105,2020-03-01,"Contra Costa County, CA",536153
"772","2020","M04","April",80507,533284,0.150964589224503,2020-04-01,"Contra Costa County, CA",452777
"773","2020","M05","May",74455,532347,0.13986178188287,2020-05-01,"Contra Costa County, CA",457892
"774","2020","M06","June",69715,540204,0.129053098459101,2020-06-01,"Contra Costa County, CA",470489
"775","2020","M07","July",64352,539228,0.119340983776807,2020-07-01,"Contra Costa County, CA",474876
"776","2020","M08","August",56183,534088,0.105194275100732,2020-08-01,"Contra Costa County, CA",477905
"777","2020","M09","September",51257,531215,0.0964901217021357,2020-09-01,"Contra Costa County, CA",479958
"778","2020","M10","October",45573,540515,0.0843140338380989,2020-10-01,"Contra Costa County, CA",494942
"779","2020","M11","November",36787,532913,0.0690300292918356,2020-11-01,"Contra Costa County, CA",496126
"780","2020","M12","December",41416,537240,0.0770903134539498,2020-12-01,"Contra Costa County, CA",495824
"781","2021","M01","January",40127,534726,0.0750421711306351,2021-01-01,"Contra Costa County, CA",494599
"782","2021","M02","February",38085,540695,0.0704371225922193,2021-02-01,"Contra Costa County, CA",502610
"783","2021","M03","March",35897,537379,0.0668001540811978,2021-03-01,"Contra Costa County, CA",501482
"784","2021","M04","April",34922,529373,0.0659686081458631,2021-04-01,"Contra Costa County, CA",494451
"785","2021","M05","May",33251,532992,0.062385551753122,2021-05-01,"Contra Costa County, CA",499741
"786","2021","M06","June",37325,535989,0.0696376231601768,2021-06-01,"Contra Costa County, CA",498664
"787","2021","M07","July",36584,541524,0.0675574859101351,2021-07-01,"Contra Costa County, CA",504940
"788","2021","M08","August",34995,537970,0.0650500957302452,2021-08-01,"Contra Costa County, CA",502975
"789","2021","M09","September",29811,538620,0.05534699788348,2021-09-01,"Contra Costa County, CA",508809
"790","2021","M10","October",28789,541477,0.053167539895508,2021-10-01,"Contra Costa County, CA",512688
"791","2021","M11","November",24722,542342,0.0455837829266404,2021-11-01,"Contra Costa County, CA",517620
"792","2021","M12","December",22924,542961,0.0422203436342573,2021-12-01,"Contra Costa County, CA",520037
"793","2020","M01","January",6701,150336,0.0445734887186037,2020-01-01,"Corpus Christi, TX",143635
"794","2020","M02","February",6206,151488,0.0409669412758766,2020-02-01,"Corpus Christi, TX",145282
"795","2020","M03","March",8569,149002,0.0575092951772459,2020-03-01,"Corpus Christi, TX",140433
"796","2020","M04","April",21561,144068,0.149658494599772,2020-04-01,"Corpus Christi, TX",122507
"797","2020","M05","May",19270,145724,0.132236282287063,2020-05-01,"Corpus Christi, TX",126454
"798","2020","M06","June",17189,151605,0.113380165561822,2020-06-01,"Corpus Christi, TX",134416
"799","2020","M07","July",17161,150551,0.113987950926928,2020-07-01,"Corpus Christi, TX",133390
"800","2020","M08","August",12166,150073,0.0810672139558748,2020-08-01,"Corpus Christi, TX",137907
"801","2020","M09","September",13836,148714,0.0930376427236171,2020-09-01,"Corpus Christi, TX",134878
"802","2020","M10","October",12193,149700,0.0814495657982632,2020-10-01,"Corpus Christi, TX",137507
"803","2020","M11","November",12306,147835,0.0832414516183583,2020-11-01,"Corpus Christi, TX",135529
"804","2020","M12","December",12039,148089,0.081295707311144,2020-12-01,"Corpus Christi, TX",136050
"805","2021","M01","January",12996,147067,0.0883678867454969,2021-01-01,"Corpus Christi, TX",134071
"806","2021","M02","February",13454,148899,0.0903565504133674,2021-02-01,"Corpus Christi, TX",135445
"807","2021","M03","March",12626,149174,0.0846394143751592,2021-03-01,"Corpus Christi, TX",136548
"808","2021","M04","April",11444,148717,0.0769515253804205,2021-04-01,"Corpus Christi, TX",137273
"809","2021","M05","May",10625,148667,0.0714684496223103,2021-05-01,"Corpus Christi, TX",138042
"810","2021","M06","June",12017,149484,0.0803898745016189,2021-06-01,"Corpus Christi, TX",137467
"811","2021","M07","July",10738,150289,0.0714490082441163,2021-07-01,"Corpus Christi, TX",139551
"812","2021","M08","August",9674,149652,0.0646433058027958,2021-08-01,"Corpus Christi, TX",139978
"813","2021","M09","September",9051,150227,0.0602488234471833,2021-09-01,"Corpus Christi, TX",141176
"814","2021","M10","October",8692,150479,0.0577622126675483,2021-10-01,"Corpus Christi, TX",141787
"815","2021","M11","November",8496,151069,0.056239201954074,2021-11-01,"Corpus Christi, TX",142573
"816","2021","M12","December",8118,150632,0.0538929311168942,2021-12-01,"Corpus Christi, TX",142514
"817","2020","M01","January",23654,690058,0.0342782780577864,2020-01-01,"Dallas, TX",666404
"818","2020","M02","February",23283,694684,0.0335159583350128,2020-02-01,"Dallas, TX",671401
"819","2020","M03","March",33322,678291,0.049126407397415,2020-03-01,"Dallas, TX",644969
"820","2020","M04","April",86000,652846,0.131730913569203,2020-04-01,"Dallas, TX",566846
"821","2020","M05","May",81884,665559,0.12303041503458,2020-05-01,"Dallas, TX",583675
"822","2020","M06","June",75663,692870,0.10920230346241,2020-06-01,"Dallas, TX",617207
"823","2020","M07","July",69170,692194,0.0999286327243518,2020-07-01,"Dallas, TX",623024
"824","2020","M08","August",50137,697739,0.0718563818275888,2020-08-01,"Dallas, TX",647602
"825","2020","M09","September",57690,694193,0.0831036901841419,2020-09-01,"Dallas, TX",636503
"826","2020","M10","October",50775,703677,0.0721566855247507,2020-10-01,"Dallas, TX",652902
"827","2020","M11","November",49308,696884,0.0707549606534229,2020-11-01,"Dallas, TX",647576
"828","2020","M12","December",48034,703517,0.0682769570600284,2020-12-01,"Dallas, TX",655483
"829","2021","M01","January",50707,695883,0.0728671342740087,2021-01-01,"Dallas, TX",645176
"830","2021","M02","February",53171,695220,0.076480826213285,2021-02-01,"Dallas, TX",642049
"831","2021","M03","March",51617,697508,0.0740020186148403,2021-03-01,"Dallas, TX",645891
"832","2021","M04","April",45356,695544,0.0652093900601544,2021-04-01,"Dallas, TX",650188
"833","2021","M05","May",41543,696836,0.0596166099340447,2021-05-01,"Dallas, TX",655293
"834","2021","M06","June",45262,702385,0.0644404422076212,2021-06-01,"Dallas, TX",657123
"835","2021","M07","July",41502,708465,0.0585801698037306,2021-07-01,"Dallas, TX",666963
"836","2021","M08","August",37133,709134,0.0523638691700017,2021-08-01,"Dallas, TX",672001
"837","2021","M09","September",33927,708579,0.0478803351496446,2021-09-01,"Dallas, TX",674652
"838","2021","M10","October",32624,713739,0.0457085853512278,2021-10-01,"Dallas, TX",681115
"839","2021","M11","November",31277,722822,0.0432706807485107,2021-11-01,"Dallas, TX",691545
"840","2021","M12","December",28612,720484,0.0397121934699452,2021-12-01,"Dallas, TX",691872
"841","2020","M01","January",7493,319316,0.0234657831114006,2020-01-01,"Dane County, WI",311823
"842","2020","M02","February",7017,323631,0.021682100911223,2020-02-01,"Dane County, WI",316614
"843","2020","M03","March",7772,319340,0.0243376964990292,2020-03-01,"Dane County, WI",311568
"844","2020","M04","April",34682,308729,0.112338005176061,2020-04-01,"Dane County, WI",274047
"845","2020","M05","May",25732,314060,0.0819333885244858,2020-05-01,"Dane County, WI",288328
"846","2020","M06","June",22342,315259,0.0708687142952303,2020-06-01,"Dane County, WI",292917
"847","2020","M07","July",18866,321757,0.0586343109862412,2020-07-01,"Dane County, WI",302891
"848","2020","M08","August",15134,320793,0.0471768398936386,2020-08-01,"Dane County, WI",305659
"849","2020","M09","September",13114,327713,0.0400167219487784,2020-09-01,"Dane County, WI",314599
"850","2020","M10","October",11132,321939,0.0345779790581446,2020-10-01,"Dane County, WI",310807
"851","2020","M11","November",10348,321693,0.0321673148001355,2020-11-01,"Dane County, WI",311345
"852","2020","M12","December",9720,318968,0.0304732763161195,2020-12-01,"Dane County, WI",309248
"853","2021","M01","January",10555,315599,0.0334443391772471,2021-01-01,"Dane County, WI",305044
"854","2021","M02","February",11131,319808,0.0348052581548929,2021-02-01,"Dane County, WI",308677
"855","2021","M03","March",11312,321204,0.0352174941781547,2021-03-01,"Dane County, WI",309892
"856","2021","M04","April",10441,322122,0.0324131850665276,2021-04-01,"Dane County, WI",311681
"857","2021","M05","May",9987,324971,0.0307319730068221,2021-05-01,"Dane County, WI",314984
"858","2021","M06","June",11761,330688,0.0355652457905942,2021-06-01,"Dane County, WI",318927
"859","2021","M07","July",10210,331356,0.0308127814193798,2021-07-01,"Dane County, WI",321146
"860","2021","M08","August",10150,328250,0.0309215536938309,2021-08-01,"Dane County, WI",318100
"861","2021","M09","September",6743,329602,0.0204580069295696,2021-09-01,"Dane County, WI",322859
"862","2021","M10","October",5787,329680,0.0175533851007037,2021-10-01,"Dane County, WI",323893
"863","2021","M11","November",4656,329090,0.0141481053815066,2021-11-01,"Dane County, WI",324434
"864","2021","M12","December",4499,328395,0.0136999649811964,2021-12-01,"Dane County, WI",323896
"865","2020","M01","January",4108,174986,0.0234761638073903,2020-01-01,"Davis County, UT",170878
"866","2020","M02","February",4221,175963,0.0239879974767423,2020-02-01,"Davis County, UT",171742
"867","2020","M03","March",4627,174399,0.0265311154307077,2020-03-01,"Davis County, UT",169772
"868","2020","M04","April",15419,172748,0.0892571838747771,2020-04-01,"Davis County, UT",157329
"869","2020","M05","May",11127,169350,0.065704162976085,2020-05-01,"Davis County, UT",158223
"870","2020","M06","June",9862,179042,0.0550820477876699,2020-06-01,"Davis County, UT",169180
"871","2020","M07","July",8383,179191,0.0467824834952648,2020-07-01,"Davis County, UT",170808
"872","2020","M08","August",7314,178469,0.0409819072219825,2020-08-01,"Davis County, UT",171155
"873","2020","M09","September",6165,177058,0.0348190988263733,2020-09-01,"Davis County, UT",170893
"874","2020","M10","October",5217,176355,0.0295823764565791,2020-10-01,"Davis County, UT",171138
"875","2020","M11","November",4917,177190,0.0277498730176647,2020-11-01,"Davis County, UT",172273
"876","2020","M12","December",4650,176098,0.0264057513430022,2020-12-01,"Davis County, UT",171448
"877","2021","M01","January",5327,177275,0.0300493583415597,2021-01-01,"Davis County, UT",171948
"878","2021","M02","February",5615,177573,0.0316207982069346,2021-02-01,"Davis County, UT",171958
"879","2021","M03","March",4396,177326,0.0247904988552158,2021-03-01,"Davis County, UT",172930
"880","2021","M04","April",4447,177887,0.0249990162294041,2021-04-01,"Davis County, UT",173440
"881","2021","M05","May",4425,181894,0.0243273554927595,2021-05-01,"Davis County, UT",177469
"882","2021","M06","June",5003,182853,0.0273607761425845,2021-06-01,"Davis County, UT",177850
"883","2021","M07","July",4221,181928,0.0232014863022734,2021-07-01,"Davis County, UT",177707
"884","2021","M08","August",4232,180900,0.0233941404090658,2021-08-01,"Davis County, UT",176668
"885","2021","M09","September",2579,180080,0.0143214127054642,2021-09-01,"Davis County, UT",177501
"886","2021","M10","October",2314,181069,0.012779658583192,2021-10-01,"Davis County, UT",178755
"887","2021","M11","November",2243,181134,0.0123830975962547,2021-11-01,"Davis County, UT",178891
"888","2021","M12","December",2152,180019,0.0119542937134414,2021-12-01,"Davis County, UT",177867
"889","2020","M01","January",11910,423254,0.0281391315852892,2020-01-01,"Denver, CO",411344
"890","2020","M02","February",11812,424776,0.0278075974160499,2020-02-01,"Denver, CO",412964
"891","2020","M03","March",20318,415027,0.0489558510651114,2020-03-01,"Denver, CO",394709
"892","2020","M04","April",54386,405075,0.134261556501882,2020-04-01,"Denver, CO",350689
"893","2020","M05","May",56196,422548,0.132993174739911,2020-05-01,"Denver, CO",366352
"894","2020","M06","June",55189,433127,0.127419902245762,2020-06-01,"Denver, CO",377938
"895","2020","M07","July",37525,420074,0.0893294990882559,2020-07-01,"Denver, CO",382549
"896","2020","M08","August",35947,425932,0.084396100786041,2020-08-01,"Denver, CO",389985
"897","2020","M09","September",34930,428695,0.0814798399794726,2020-09-01,"Denver, CO",393765
"898","2020","M10","October",33661,427352,0.0787664501394635,2020-10-01,"Denver, CO",393691
"899","2020","M11","November",33698,431983,0.0780076993770588,2020-11-01,"Denver, CO",398285
"900","2020","M12","December",33223,428037,0.0776171218843231,2020-12-01,"Denver, CO",394814
"901","2021","M01","January",32940,428764,0.0768254797510985,2021-01-01,"Denver, CO",395824
"902","2021","M02","February",31354,430528,0.072826854467073,2021-02-01,"Denver, CO",399174
"903","2021","M03","March",30304,426891,0.0709876760109724,2021-03-01,"Denver, CO",396587
"904","2021","M04","April",30175,432336,0.0697952518411606,2021-04-01,"Denver, CO",402161
"905","2021","M05","May",27801,431687,0.064400827451371,2021-05-01,"Denver, CO",403886
"906","2021","M06","June",29243,433751,0.0674188647403695,2021-06-01,"Denver, CO",404508
"907","2021","M07","July",28400,432681,0.0656372708762345,2021-07-01,"Denver, CO",404281
"908","2021","M08","August",25529,433119,0.0589422306571635,2021-08-01,"Denver, CO",407590
"909","2021","M09","September",22899,436769,0.0524281714132642,2021-09-01,"Denver, CO",413870
"910","2021","M10","October",21836,436184,0.0500614419602736,2021-10-01,"Denver, CO",414348
"911","2021","M11","November",21165,437475,0.0483799074232813,2021-11-01,"Denver, CO",416310
"912","2021","M12","December",19980,436110,0.0458141294627502,2021-12-01,"Denver, CO",416130
"913","2020","M01","January",14836,499348,0.0297107428086224,2020-01-01,"DuPage County, IL",484512
"914","2020","M02","February",14453,504427,0.0286523124257821,2020-02-01,"DuPage County, IL",489974
"915","2020","M03","March",15399,501824,0.0306860572631042,2020-03-01,"DuPage County, IL",486425
"916","2020","M04","April",62908,461475,0.136319410585622,2020-04-01,"DuPage County, IL",398567
"917","2020","M05","May",60736,473930,0.12815394678539,2020-05-01,"DuPage County, IL",413194
"918","2020","M06","June",61467,495118,0.124146163136868,2020-06-01,"DuPage County, IL",433651
"919","2020","M07","July",47851,477779,0.100152999608606,2020-07-01,"DuPage County, IL",429928
"920","2020","M08","August",45180,473761,0.0953645403484035,2020-08-01,"DuPage County, IL",428581
"921","2020","M09","September",43280,488356,0.0886238727485687,2020-09-01,"DuPage County, IL",445076
"922","2020","M10","October",30581,477548,0.0640375417759052,2020-10-01,"DuPage County, IL",446967
"923","2020","M11","November",31888,480617,0.06634804844606,2020-11-01,"DuPage County, IL",448729
"924","2020","M12","December",32115,476404,0.0674112727852831,2020-12-01,"DuPage County, IL",444289
"925","2021","M01","January",32123,473451,0.0678486263626014,2021-01-01,"DuPage County, IL",441328
"926","2021","M02","February",30104,477076,0.0631010572738935,2021-02-01,"DuPage County, IL",446972
"927","2021","M03","March",25830,479186,0.0539039120508529,2021-03-01,"DuPage County, IL",453356
"928","2021","M04","April",26552,483718,0.0548914863618885,2021-04-01,"DuPage County, IL",457166
"929","2021","M05","May",26583,485949,0.0547032713309421,2021-05-01,"DuPage County, IL",459366
"930","2021","M06","June",33218,496314,0.0669294035630669,2021-06-01,"DuPage County, IL",463096
"931","2021","M07","July",27895,492160,0.05667872236671,2021-07-01,"DuPage County, IL",464265
"932","2021","M08","August",25556,488246,0.0523424667073565,2021-08-01,"DuPage County, IL",462690
"933","2021","M09","September",19177,487713,0.039320255970212,2021-09-01,"DuPage County, IL",468536
"934","2021","M10","October",18561,495978,0.0374230308602398,2021-10-01,"DuPage County, IL",477417
"935","2021","M11","November",16123,501642,0.0321404507597051,2021-11-01,"DuPage County, IL",485519
"936","2021","M12","December",15457,508891,0.0303738914620223,2021-12-01,"DuPage County, IL",493434
"937","2020","M01","January",4732,153973,0.0307326609210706,2020-01-01,"Durham, NC",149241
"938","2020","M02","February",4450,155166,0.0286789631749223,2020-02-01,"Durham, NC",150716
"939","2020","M03","March",5031,147906,0.0340148472678593,2020-03-01,"Durham, NC",142875
"940","2020","M04","April",14755,141127,0.10455121982328,2020-04-01,"Durham, NC",126372
"941","2020","M05","May",17369,145833,0.119101986518826,2020-05-01,"Durham, NC",128464
"942","2020","M06","June",12555,146573,0.0856569763871927,2020-06-01,"Durham, NC",134018
"943","2020","M07","July",13550,149760,0.0904780982905983,2020-07-01,"Durham, NC",136210
"944","2020","M08","August",9916,149089,0.0665106077577823,2020-08-01,"Durham, NC",139173
"945","2020","M09","September",10288,150965,0.0681482462822509,2020-09-01,"Durham, NC",140677
"946","2020","M10","October",9249,152988,0.0604557220174131,2020-10-01,"Durham, NC",143739
"947","2020","M11","November",8906,151982,0.0585990446237054,2020-11-01,"Durham, NC",143076
"948","2020","M12","December",8599,151495,0.0567609492062444,2020-12-01,"Durham, NC",142896
"949","2021","M01","January",7993,150523,0.053101519369133,2021-01-01,"Durham, NC",142530
"950","2021","M02","February",7532,151946,0.0495702420596791,2021-02-01,"Durham, NC",144414
"951","2021","M03","March",6177,151861,0.0406753544359645,2021-03-01,"Durham, NC",145684
"952","2021","M04","April",5784,151253,0.0382405638235275,2021-04-01,"Durham, NC",145469
"953","2021","M05","May",5957,150595,0.0395564261761679,2021-05-01,"Durham, NC",144638
"954","2021","M06","June",6612,152505,0.0433559555424412,2021-06-01,"Durham, NC",145893
"955","2021","M07","July",6158,153509,0.0401149118292739,2021-07-01,"Durham, NC",147351
"956","2021","M08","August",5783,153633,0.037641652509552,2021-08-01,"Durham, NC",147850
"957","2021","M09","September",4968,154251,0.0322072466304919,2021-09-01,"Durham, NC",149283
"958","2021","M10","October",4960,155819,0.0318318048504996,2021-10-01,"Durham, NC",150859
"959","2021","M11","November",4508,155721,0.028949210446889,2021-11-01,"Durham, NC",151213
"960","2021","M12","December",4169,155432,0.0268220186319419,2021-12-01,"Durham, NC",151263
"961","2020","M01","January",5569,144613,0.0385096775531937,2020-01-01,"Dutchess County, NY",139044
"962","2020","M02","February",5667,143699,0.0394366001155192,2020-02-01,"Dutchess County, NY",138032
"963","2020","M03","March",5786,142571,0.040583288326518,2020-03-01,"Dutchess County, NY",136785
"964","2020","M04","April",20833,135063,0.154246536801345,2020-04-01,"Dutchess County, NY",114230
"965","2020","M05","May",16033,140162,0.11438906408299,2020-05-01,"Dutchess County, NY",124129
"966","2020","M06","June",16353,143275,0.114137148839644,2020-06-01,"Dutchess County, NY",126922
"967","2020","M07","July",16674,146545,0.113780749940291,2020-07-01,"Dutchess County, NY",129871
"968","2020","M08","August",12376,144336,0.0857443742378894,2020-08-01,"Dutchess County, NY",131960
"969","2020","M09","September",8317,140625,0.0591431111111111,2020-09-01,"Dutchess County, NY",132308
"970","2020","M10","October",7610,140856,0.0540268075197365,2020-10-01,"Dutchess County, NY",133246
"971","2020","M11","November",7615,141790,0.0537061852034699,2020-11-01,"Dutchess County, NY",134175
"972","2020","M12","December",7828,141199,0.0554394861153408,2020-12-01,"Dutchess County, NY",133371
"973","2021","M01","January",8589,140796,0.0610031534986789,2021-01-01,"Dutchess County, NY",132207
"974","2021","M02","February",9044,140170,0.064521652279375,2021-02-01,"Dutchess County, NY",131126
"975","2021","M03","March",8076,140537,0.0574652938372101,2021-03-01,"Dutchess County, NY",132461
"976","2021","M04","April",6999,140537,0.0498018315461409,2021-04-01,"Dutchess County, NY",133538
"977","2021","M05","May",6246,139776,0.044685782967033,2021-05-01,"Dutchess County, NY",133530
"978","2021","M06","June",6927,140940,0.0491485738612175,2021-06-01,"Dutchess County, NY",134013
"979","2021","M07","July",7144,140665,0.050787331603455,2021-07-01,"Dutchess County, NY",133521
"980","2021","M08","August",6882,139821,0.0492200742377754,2021-08-01,"Dutchess County, NY",132939
"981","2021","M09","September",5718,137310,0.041642997596679,2021-09-01,"Dutchess County, NY",131592
"982","2021","M10","October",5444,137509,0.0395901359183762,2021-10-01,"Dutchess County, NY",132065
"983","2021","M11","November",4776,136443,0.0350036278885689,2021-11-01,"Dutchess County, NY",131667
"984","2021","M12","December",3568,136115,0.0262131286044889,2021-12-01,"Dutchess County, NY",132547
"985","2020","M01","January",17411,464902,0.0374509036313029,2020-01-01,"Duval County/City of Jacksonville, FL",447491
"986","2020","M02","February",15772,466300,0.0338237186360712,2020-02-01,"Duval County/City of Jacksonville, FL",450528
"987","2020","M03","March",26401,472351,0.0558927577161899,2020-03-01,"Duval County/City of Jacksonville, FL",445950
"988","2020","M04","April",51957,433578,0.119833109613495,2020-04-01,"Duval County/City of Jacksonville, FL",381621
"989","2020","M05","May",53321,449248,0.118689454377092,2020-05-01,"Duval County/City of Jacksonville, FL",395927
"990","2020","M06","June",43583,450779,0.0966837408131257,2020-06-01,"Duval County/City of Jacksonville, FL",407196
"991","2020","M07","July",47262,463109,0.102053728171985,2020-07-01,"Duval County/City of Jacksonville, FL",415847
"992","2020","M08","August",32933,457948,0.0719142784770323,2020-08-01,"Duval County/City of Jacksonville, FL",425015
"993","2020","M09","September",27518,462740,0.0594675195574189,2020-09-01,"Duval County/City of Jacksonville, FL",435222
"994","2020","M10","October",22625,460801,0.0490992858088416,2020-10-01,"Duval County/City of Jacksonville, FL",438176
"995","2020","M11","November",19912,460549,0.0432353560641756,2020-11-01,"Duval County/City of Jacksonville, FL",440637
"996","2020","M12","December",16320,459202,0.035539914895841,2020-12-01,"Duval County/City of Jacksonville, FL",442882
"997","2021","M01","January",21339,461808,0.0462075148113502,2021-01-01,"Duval County/City of Jacksonville, FL",440469
"998","2021","M02","February",22051,466021,0.0473176101506155,2021-02-01,"Duval County/City of Jacksonville, FL",443970
"999","2021","M03","March",23005,471112,0.0488312757900457,2021-03-01,"Duval County/City of Jacksonville, FL",448107
"1000","2021","M04","April",23544,476058,0.0494561587033513,2021-04-01,"Duval County/City of Jacksonville, FL",452514
"1001","2021","M05","May",23113,481629,0.0479892199182358,2021-05-01,"Duval County/City of Jacksonville, FL",458516
"1002","2021","M06","June",27112,490208,0.0553071349304785,2021-06-01,"Duval County/City of Jacksonville, FL",463096
"1003","2021","M07","July",24538,492080,0.0498658754674037,2021-07-01,"Duval County/City of Jacksonville, FL",467542
"1004","2021","M08","August",23156,489234,0.0473311339767882,2021-08-01,"Duval County/City of Jacksonville, FL",466078
"1005","2021","M09","September",20165,489084,0.0412301363364984,2021-09-01,"Duval County/City of Jacksonville, FL",468919
"1006","2021","M10","October",20023,490497,0.0408218602764135,2021-10-01,"Duval County/City of Jacksonville, FL",470474
"1007","2021","M11","November",18185,489814,0.037126337752698,2021-11-01,"Duval County/City of Jacksonville, FL",471629
"1008","2021","M12","December",17408,489301,0.03557728269511,2021-12-01,"Duval County/City of Jacksonville, FL",471893
"1009","2020","M01","January",11000,231978,0.0474182896653993,2020-01-01,"East Baton Rouge Parish, LA",220978
"1010","2020","M02","February",8863,233876,0.0378961500966324,2020-02-01,"East Baton Rouge Parish, LA",225013
"1011","2020","M03","March",11716,235641,0.049719700731197,2020-03-01,"East Baton Rouge Parish, LA",223925
"1012","2020","M04","April",26363,220671,0.119467442482247,2020-04-01,"East Baton Rouge Parish, LA",194308
"1013","2020","M05","May",28905,223532,0.129310344827586,2020-05-01,"East Baton Rouge Parish, LA",194627
"1014","2020","M06","June",21739,216348,0.100481631445634,2020-06-01,"East Baton Rouge Parish, LA",194609
"1015","2020","M07","July",21338,217866,0.0979409361717753,2020-07-01,"East Baton Rouge Parish, LA",196528
"1016","2020","M08","August",18349,232565,0.0788983724980113,2020-08-01,"East Baton Rouge Parish, LA",214216
"1017","2020","M09","September",17422,233230,0.0746987951807229,2020-09-01,"East Baton Rouge Parish, LA",215808
"1018","2020","M10","October",15953,234560,0.068012448840382,2020-10-01,"East Baton Rouge Parish, LA",218607
"1019","2020","M11","November",15913,234741,0.0677896064172854,2020-11-01,"East Baton Rouge Parish, LA",218828
"1020","2020","M12","December",15768,232690,0.0677639778245735,2020-12-01,"East Baton Rouge Parish, LA",216922
"1021","2021","M01","January",16418,229655,0.0714898434608434,2021-01-01,"East Baton Rouge Parish, LA",213237
"1022","2021","M02","February",15118,229025,0.0660102608885493,2021-02-01,"East Baton Rouge Parish, LA",213907
"1023","2021","M03","March",14042,230226,0.0609922424052887,2021-03-01,"East Baton Rouge Parish, LA",216184
"1024","2021","M04","April",14493,229580,0.0631283212823417,2021-04-01,"East Baton Rouge Parish, LA",215087
"1025","2021","M05","May",15035,230312,0.0652810101080274,2021-05-01,"East Baton Rouge Parish, LA",215277
"1026","2021","M06","June",16950,230289,0.0736031681930096,2021-06-01,"East Baton Rouge Parish, LA",213339
"1027","2021","M07","July",14600,231679,0.0630182278065772,2021-07-01,"East Baton Rouge Parish, LA",217079
"1028","2021","M08","August",12360,229592,0.0538346283842643,2021-08-01,"East Baton Rouge Parish, LA",217232
"1029","2021","M09","September",10377,230465,0.0450263597509383,2021-09-01,"East Baton Rouge Parish, LA",220088
"1030","2021","M10","October",9212,231839,0.0397344709043776,2021-10-01,"East Baton Rouge Parish, LA",222627
"1031","2021","M11","November",8787,232266,0.0378316240861771,2021-11-01,"East Baton Rouge Parish, LA",223479
"1032","2021","M12","December",8022,231089,0.034713898108521,2021-12-01,"East Baton Rouge Parish, LA",223067
"1033","2020","M01","January",11348,343639,0.0330230270720145,2020-01-01,"El Paso County, CO",332291
"1034","2020","M02","February",11534,345732,0.0333611005055939,2020-02-01,"El Paso County, CO",334198
"1035","2020","M03","March",19523,339157,0.0575633113867619,2020-03-01,"El Paso County, CO",319634
"1036","2020","M04","April",40622,325340,0.124860146308477,2020-04-01,"El Paso County, CO",284718
"1037","2020","M05","May",37901,337811,0.112195872840138,2020-05-01,"El Paso County, CO",299910
"1038","2020","M06","June",38918,349088,0.111484783206527,2020-06-01,"El Paso County, CO",310170
"1039","2020","M07","July",23939,341765,0.0700452065015435,2020-07-01,"El Paso County, CO",317826
"1040","2020","M08","August",22946,346896,0.0661466260781329,2020-08-01,"El Paso County, CO",323950
"1041","2020","M09","September",22786,350164,0.0650723660913172,2020-09-01,"El Paso County, CO",327378
"1042","2020","M10","October",22213,348424,0.0637527839643653,2020-10-01,"El Paso County, CO",326211
"1043","2020","M11","November",22905,352258,0.0650233635573926,2020-11-01,"El Paso County, CO",329353
"1044","2020","M12","December",25801,349175,0.073891315243073,2020-12-01,"El Paso County, CO",323374
"1045","2021","M01","January",24982,348668,0.0716498216068007,2021-01-01,"El Paso County, CO",323686
"1046","2021","M02","February",24458,350130,0.0698540542084369,2021-02-01,"El Paso County, CO",325672
"1047","2021","M03","March",23570,349452,0.0674484621636162,2021-03-01,"El Paso County, CO",325882
"1048","2021","M04","April",22765,353967,0.0643139049685423,2021-04-01,"El Paso County, CO",331202
"1049","2021","M05","May",20828,355764,0.0585444283288922,2021-05-01,"El Paso County, CO",334936
"1050","2021","M06","June",23215,356218,0.0651707662161935,2021-06-01,"El Paso County, CO",333003
"1051","2021","M07","July",22432,357313,0.062779691754848,2021-07-01,"El Paso County, CO",334881
"1052","2021","M08","August",20005,357841,0.0559047174583125,2021-08-01,"El Paso County, CO",337836
"1053","2021","M09","September",17601,359628,0.0489422403149922,2021-09-01,"El Paso County, CO",342027
"1054","2021","M10","October",16710,359579,0.0464710119333999,2021-10-01,"El Paso County, CO",342869
"1055","2021","M11","November",16538,359723,0.0459742635305499,2021-11-01,"El Paso County, CO",343185
"1056","2021","M12","December",15431,358999,0.0429834066390157,2021-12-01,"El Paso County, CO",343568
"1057","2020","M01","January",14431,365693,0.039462062440353,2020-01-01,"El Paso County, TX",351262
"1058","2020","M02","February",13884,367700,0.0377590426978515,2020-02-01,"El Paso County, TX",353816
"1059","2020","M03","March",18854,360545,0.0522930563452551,2020-03-01,"El Paso County, TX",341691
"1060","2020","M04","April",49799,347937,0.143126485541923,2020-04-01,"El Paso County, TX",298138
"1061","2020","M05","May",46878,353658,0.132551787319953,2020-05-01,"El Paso County, TX",306780
"1062","2020","M06","June",40814,366594,0.111332973261974,2020-06-01,"El Paso County, TX",325780
"1063","2020","M07","July",36467,365441,0.0997890220309161,2020-07-01,"El Paso County, TX",328974
"1064","2020","M08","August",26169,367401,0.0712273510415051,2020-08-01,"El Paso County, TX",341232
"1065","2020","M09","September",29959,365158,0.0820439371450167,2020-09-01,"El Paso County, TX",335199
"1066","2020","M10","October",26754,369100,0.0724844215659713,2020-10-01,"El Paso County, TX",342346
"1067","2020","M11","November",29597,370112,0.0799676854573751,2020-11-01,"El Paso County, TX",340515
"1068","2020","M12","December",27517,369671,0.0744364583643294,2020-12-01,"El Paso County, TX",342154
"1069","2021","M01","January",29432,366877,0.0802230720377674,2021-01-01,"El Paso County, TX",337445
"1070","2021","M02","February",30387,367119,0.0827715263987971,2021-02-01,"El Paso County, TX",336732
"1071","2021","M03","March",28472,365783,0.0778384998756093,2021-03-01,"El Paso County, TX",337311
"1072","2021","M04","April",25547,364724,0.0700447461642228,2021-04-01,"El Paso County, TX",339177
"1073","2021","M05","May",23499,364072,0.0645449251796348,2021-05-01,"El Paso County, TX",340573
"1074","2021","M06","June",26450,363878,0.0726891980279104,2021-06-01,"El Paso County, TX",337428
"1075","2021","M07","July",23542,364601,0.064569214017515,2021-07-01,"El Paso County, TX",341059
"1076","2021","M08","August",21036,364996,0.0576335083124199,2021-08-01,"El Paso County, TX",343960
"1077","2021","M09","September",19644,367592,0.0534396831269451,2021-09-01,"El Paso County, TX",347948
"1078","2021","M10","October",19346,368968,0.0524327312937707,2021-10-01,"El Paso County, TX",349622
"1079","2021","M11","November",18481,371147,0.0497942863609298,2021-11-01,"El Paso County, TX",352666
"1080","2021","M12","December",17409,367782,0.0473351061226487,2021-12-01,"El Paso County, TX",350373
"1081","2020","M01","January",21053,442271,0.047602035855844,2020-01-01,"Erie County, NY",421218
"1082","2020","M02","February",21039,439077,0.0479164246817756,2020-02-01,"Erie County, NY",418038
"1083","2020","M03","March",21974,438863,0.0500702952857726,2020-03-01,"Erie County, NY",416889
"1084","2020","M04","April",85708,423240,0.202504489178717,2020-04-01,"Erie County, NY",337532
"1085","2020","M05","May",65039,429894,0.151290783309374,2020-05-01,"Erie County, NY",364855
"1086","2020","M06","June",60350,445758,0.135387362649689,2020-06-01,"Erie County, NY",385408
"1087","2020","M07","July",59417,453102,0.131133828586058,2020-07-01,"Erie County, NY",393685
"1088","2020","M08","August",45083,447369,0.100773634292944,2020-08-01,"Erie County, NY",402286
"1089","2020","M09","September",30200,435391,0.0693629404374459,2020-09-01,"Erie County, NY",405191
"1090","2020","M10","October",27780,436798,0.0635991923039941,2020-10-01,"Erie County, NY",409018
"1091","2020","M11","November",28255,437448,0.0645905341892065,2020-11-01,"Erie County, NY",409193
"1092","2020","M12","December",35159,442280,0.0794948901148594,2020-12-01,"Erie County, NY",407121
"1093","2021","M01","January",34387,438292,0.0784568278681792,2021-01-01,"Erie County, NY",403905
"1094","2021","M02","February",34785,437022,0.0795955352362124,2021-02-01,"Erie County, NY",402237
"1095","2021","M03","March",31141,438583,0.0710036640727069,2021-03-01,"Erie County, NY",407442
"1096","2021","M04","April",26451,438966,0.0602575142493952,2021-04-01,"Erie County, NY",412515
"1097","2021","M05","May",23732,440301,0.0538994914842346,2021-05-01,"Erie County, NY",416569
"1098","2021","M06","June",25270,444994,0.0567872825251576,2021-06-01,"Erie County, NY",419724
"1099","2021","M07","July",25718,446918,0.0575452320112414,2021-07-01,"Erie County, NY",421200
"1100","2021","M08","August",24880,444498,0.0559732552227457,2021-08-01,"Erie County, NY",419618
"1101","2021","M09","September",20495,437360,0.0468607097128224,2021-09-01,"Erie County, NY",416865
"1102","2021","M10","October",19956,433745,0.0460085995227611,2021-10-01,"Erie County, NY",413789
"1103","2021","M11","November",18399,430846,0.0427043537598121,2021-11-01,"Erie County, NY",412447
"1104","2021","M12","December",13973,427613,0.032676742755716,2021-12-01,"Erie County, NY",413640
"1105","2020","M01","January",5601,145807,0.0384137935764401,2020-01-01,"Escambia County, FL",140206
"1106","2020","M02","February",4980,146834,0.0339158505523244,2020-02-01,"Escambia County, FL",141854
"1107","2020","M03","March",8060,149662,0.0538546858922105,2020-03-01,"Escambia County, FL",141602
"1108","2020","M04","April",17769,139408,0.127460403994032,2020-04-01,"Escambia County, FL",121639
"1109","2020","M05","May",16181,142844,0.11327742152278,2020-05-01,"Escambia County, FL",126663
"1110","2020","M06","June",12571,142705,0.0880908167198066,2020-06-01,"Escambia County, FL",130134
"1111","2020","M07","July",14353,146885,0.0977159001940293,2020-07-01,"Escambia County, FL",132532
"1112","2020","M08","August",9855,145288,0.0678307912559881,2020-08-01,"Escambia County, FL",135433
"1113","2020","M09","September",8282,145215,0.0570326756877733,2020-09-01,"Escambia County, FL",136933
"1114","2020","M10","October",7001,144936,0.048304079041784,2020-10-01,"Escambia County, FL",137935
"1115","2020","M11","November",6261,144127,0.043440854246602,2020-11-01,"Escambia County, FL",137866
"1116","2020","M12","December",5133,143632,0.0357371616352902,2020-12-01,"Escambia County, FL",138499
"1117","2021","M01","January",6528,146037,0.0447010004313975,2021-01-01,"Escambia County, FL",139509
"1118","2021","M02","February",7154,149136,0.04796963845081,2021-02-01,"Escambia County, FL",141982
"1119","2021","M03","March",7307,149554,0.0488586062559343,2021-03-01,"Escambia County, FL",142247
"1120","2021","M04","April",7424,151106,0.0491310735510172,2021-04-01,"Escambia County, FL",143682
"1121","2021","M05","May",7237,152051,0.0475958724375374,2021-05-01,"Escambia County, FL",144814
"1122","2021","M06","June",8593,153617,0.0559378193819694,2021-06-01,"Escambia County, FL",145024
"1123","2021","M07","July",7844,154614,0.0507327926319738,2021-07-01,"Escambia County, FL",146770
"1124","2021","M08","August",7403,154005,0.0480698678614331,2021-08-01,"Escambia County, FL",146602
"1125","2021","M09","September",6381,153038,0.0416955266012363,2021-09-01,"Escambia County, FL",146657
"1126","2021","M10","October",6357,154297,0.0411997640913304,2021-10-01,"Escambia County, FL",147940
"1127","2021","M11","November",5769,153439,0.0375980031152445,2021-11-01,"Escambia County, FL",147670
"1128","2021","M12","December",5537,153258,0.0361286197131634,2021-12-01,"Escambia County, FL",147721
"1129","2020","M01","January",14135,643006,0.0219826875643462,2020-01-01,"Fairfax County, VA",628871
"1130","2020","M02","February",12454,646203,0.0192725815262387,2020-02-01,"Fairfax County, VA",633749
"1131","2020","M03","March",14242,643716,0.022124663671557,2020-03-01,"Fairfax County, VA",629474
"1132","2020","M04","April",64249,629414,0.102077487949108,2020-04-01,"Fairfax County, VA",565165
"1133","2020","M05","May",50222,617824,0.0812885222976123,2020-05-01,"Fairfax County, VA",567602
"1134","2020","M06","June",53694,632483,0.0848939813402099,2020-06-01,"Fairfax County, VA",578789
"1135","2020","M07","July",47841,629560,0.0759911684350975,2020-07-01,"Fairfax County, VA",581719
"1136","2020","M08","August",42700,637041,0.0670286527868693,2020-08-01,"Fairfax County, VA",594341
"1137","2020","M09","September",37822,619346,0.0610676423194789,2020-09-01,"Fairfax County, VA",581524
"1138","2020","M10","October",34457,616846,0.0558599715326029,2020-10-01,"Fairfax County, VA",582389
"1139","2020","M11","November",33079,614527,0.0538283915922327,2020-11-01,"Fairfax County, VA",581448
"1140","2020","M12","December",33290,610804,0.0545019351543212,2020-12-01,"Fairfax County, VA",577514
"1141","2021","M01","January",31099,607686,0.0511761008152237,2021-01-01,"Fairfax County, VA",576587
"1142","2021","M02","February",29150,610262,0.0477663691988031,2021-02-01,"Fairfax County, VA",581112
"1143","2021","M03","March",27931,614218,0.045474082491884,2021-03-01,"Fairfax County, VA",586287
"1144","2021","M04","April",21772,611869,0.0355827799741448,2021-04-01,"Fairfax County, VA",590097
"1145","2021","M05","May",22761,617310,0.0368712640326578,2021-05-01,"Fairfax County, VA",594549
"1146","2021","M06","June",25311,622841,0.0406379798375508,2021-06-01,"Fairfax County, VA",597530
"1147","2021","M07","July",23415,625017,0.0374629810069166,2021-07-01,"Fairfax County, VA",601602
"1148","2021","M08","August",21208,619888,0.0342126319593217,2021-08-01,"Fairfax County, VA",598680
"1149","2021","M09","September",16631,611721,0.0271872307800451,2021-09-01,"Fairfax County, VA",595090
"1150","2021","M10","October",14980,619963,0.0241627322920884,2021-10-01,"Fairfax County, VA",604983
"1151","2021","M11","November",14271,621058,0.0229785301855865,2021-11-01,"Fairfax County, VA",606787
"1152","2021","M12","December",13423,617516,0.0217370885936559,2021-12-01,"Fairfax County, VA",604093
"1153","2020","M01","January",14407,402721,0.0357741463693227,2020-01-01,"Fort Bend County, TX",388314
"1154","2020","M02","February",13877,406595,0.0341297851670581,2020-02-01,"Fort Bend County, TX",392718
"1155","2020","M03","March",19612,397145,0.0493824673607876,2020-03-01,"Fort Bend County, TX",377533
"1156","2020","M04","April",47211,377642,0.125015226060661,2020-04-01,"Fort Bend County, TX",330431
"1157","2020","M05","May",45023,385001,0.116942553395965,2020-05-01,"Fort Bend County, TX",339978
"1158","2020","M06","June",41291,398852,0.103524615646907,2020-06-01,"Fort Bend County, TX",357561
"1159","2020","M07","July",38808,394707,0.0983210330701001,2020-07-01,"Fort Bend County, TX",355899
"1160","2020","M08","August",28173,394949,0.0713332607501222,2020-08-01,"Fort Bend County, TX",366776
"1161","2020","M09","September",32512,392798,0.0827702788710737,2020-09-01,"Fort Bend County, TX",360286
"1162","2020","M10","October",28847,397782,0.0725196213001091,2020-10-01,"Fort Bend County, TX",368935
"1163","2020","M11","November",28928,394667,0.0732972353908485,2020-11-01,"Fort Bend County, TX",365739
"1164","2020","M12","December",27762,396512,0.0700155354692922,2020-12-01,"Fort Bend County, TX",368750
"1165","2021","M01","January",30102,392731,0.0766478836659189,2021-01-01,"Fort Bend County, TX",362629
"1166","2021","M02","February",31320,393550,0.0795832803963918,2021-02-01,"Fort Bend County, TX",362230
"1167","2021","M03","March",30060,395725,0.0759618421883884,2021-03-01,"Fort Bend County, TX",365665
"1168","2021","M04","April",26949,396365,0.0679903624184779,2021-04-01,"Fort Bend County, TX",369416
"1169","2021","M05","May",24880,397095,0.0626550321711429,2021-05-01,"Fort Bend County, TX",372215
"1170","2021","M06","June",27842,398375,0.0698889237527455,2021-06-01,"Fort Bend County, TX",370533
"1171","2021","M07","July",25614,400759,0.0639137237092617,2021-07-01,"Fort Bend County, TX",375145
"1172","2021","M08","August",22945,399830,0.0573868894280069,2021-08-01,"Fort Bend County, TX",376885
"1173","2021","M09","September",20902,400723,0.0521607194995046,2021-09-01,"Fort Bend County, TX",379821
"1174","2021","M10","October",20225,402321,0.0502708036617527,2021-10-01,"Fort Bend County, TX",382096
"1175","2021","M11","November",19308,405669,0.0475954534361758,2021-11-01,"Fort Bend County, TX",386361
"1176","2021","M12","December",18000,405981,0.0443370502560465,2021-12-01,"Fort Bend County, TX",387981
"1177","2020","M01","January",4564,129997,0.0351085025039039,2020-01-01,"Fort Wayne, IN",125433
"1178","2020","M02","February",4618,129405,0.0356864108805688,2020-02-01,"Fort Wayne, IN",124787
"1179","2020","M03","March",4858,127252,0.0381762172696696,2020-03-01,"Fort Wayne, IN",122394
"1180","2020","M04","April",25544,125910,0.202875069494083,2020-04-01,"Fort Wayne, IN",100366
"1181","2020","M05","May",19314,127563,0.151407539803862,2020-05-01,"Fort Wayne, IN",108249
"1182","2020","M06","June",15614,129854,0.120242734147581,2020-06-01,"Fort Wayne, IN",114240
"1183","2020","M07","July",13986,131440,0.106405964698722,2020-07-01,"Fort Wayne, IN",117454
"1184","2020","M08","August",11022,131357,0.0839087372580068,2020-08-01,"Fort Wayne, IN",120335
"1185","2020","M09","September",9194,129819,0.0708216824963988,2020-09-01,"Fort Wayne, IN",120625
"1186","2020","M10","October",7653,130042,0.058850217621999,2020-10-01,"Fort Wayne, IN",122389
"1187","2020","M11","November",7179,130085,0.0551869931198832,2020-11-01,"Fort Wayne, IN",122906
"1188","2020","M12","December",6390,128478,0.0497361415962266,2020-12-01,"Fort Wayne, IN",122088
"1189","2021","M01","January",6826,131001,0.0521064724696758,2021-01-01,"Fort Wayne, IN",124175
"1190","2021","M02","February",6400,129738,0.0493301885338143,2021-02-01,"Fort Wayne, IN",123338
"1191","2021","M03","March",6582,129185,0.050950187715292,2021-03-01,"Fort Wayne, IN",122603
"1192","2021","M04","April",6068,128468,0.0472335523243142,2021-04-01,"Fort Wayne, IN",122400
"1193","2021","M05","May",6502,129892,0.0500569704061836,2021-05-01,"Fort Wayne, IN",123390
"1194","2021","M06","June",6706,131496,0.0509977489809576,2021-06-01,"Fort Wayne, IN",124790
"1195","2021","M07","July",5970,130366,0.0457941487811239,2021-07-01,"Fort Wayne, IN",124396
"1196","2021","M08","August",6757,128633,0.05252928875172,2021-08-01,"Fort Wayne, IN",121876
"1197","2021","M09","September",4101,127067,0.0322743119771459,2021-09-01,"Fort Wayne, IN",122966
"1198","2021","M10","October",3545,127139,0.0278828683566805,2021-10-01,"Fort Wayne, IN",123594
"1199","2021","M11","November",2911,127163,0.0228918789270464,2021-11-01,"Fort Wayne, IN",124252
"1200","2021","M12","December",1740,125552,0.0138587995412259,2021-12-01,"Fort Wayne, IN",123812
"1201","2020","M01","January",29319,703424,0.0416804089709763,2020-01-01,"Franklin County, OH",674105
"1202","2020","M02","February",27280,705958,0.0386425254760198,2020-02-01,"Franklin County, OH",678678
"1203","2020","M03","March",32567,702060,0.0463877731248041,2020-03-01,"Franklin County, OH",669493
"1204","2020","M04","April",88935,661474,0.134449728938704,2020-04-01,"Franklin County, OH",572539
"1205","2020","M05","May",91308,710672,0.128481212148502,2020-05-01,"Franklin County, OH",619364
"1206","2020","M06","June",69357,704677,0.0984238168692891,2020-06-01,"Franklin County, OH",635320
"1207","2020","M07","July",71688,720896,0.0994429154829545,2020-07-01,"Franklin County, OH",649208
"1208","2020","M08","August",67573,729146,0.0926741695078901,2020-08-01,"Franklin County, OH",661573
"1209","2020","M09","September",53596,710683,0.0754147770524974,2020-09-01,"Franklin County, OH",657087
"1210","2020","M10","October",33604,702631,0.0478259570101518,2020-10-01,"Franklin County, OH",669027
"1211","2020","M11","November",32324,707837,0.0456658807041734,2020-11-01,"Franklin County, OH",675513
"1212","2020","M12","December",32660,702319,0.0465030847805627,2020-12-01,"Franklin County, OH",669659
"1213","2021","M01","January",39572,704606,0.0561618833787961,2021-01-01,"Franklin County, OH",665034
"1214","2021","M02","February",40820,710980,0.0574137106529016,2021-02-01,"Franklin County, OH",670160
"1215","2021","M03","March",39283,714154,0.0550063431696805,2021-03-01,"Franklin County, OH",674871
"1216","2021","M04","April",35253,709754,0.0496693220467937,2021-04-01,"Franklin County, OH",674501
"1217","2021","M05","May",34804,674425,0.0516054416725359,2021-05-01,"Franklin County, OH",639621
"1218","2021","M06","June",41766,689278,0.0605938387704235,2021-06-01,"Franklin County, OH",647512
"1219","2021","M07","July",40020,697273,0.0573950231831722,2021-07-01,"Franklin County, OH",657253
"1220","2021","M08","August",34380,700224,0.0490985741705511,2021-08-01,"Franklin County, OH",665844
"1221","2021","M09","September",29419,694886,0.0423364407974833,2021-09-01,"Franklin County, OH",665467
"1222","2021","M10","October",25686,700636,0.0366609765984049,2021-10-01,"Franklin County, OH",674950
"1223","2021","M11","November",22344,702287,0.0318160524116209,2021-11-01,"Franklin County, OH",679943
"1224","2021","M12","December",20316,699724,0.0290343049545249,2021-12-01,"Franklin County, OH",679408
"1225","2020","M01","January",20426,566508,0.0360559780267887,2020-01-01,"Fulton County, GA",546082
"1226","2020","M02","February",19723,569635,0.0346239258472531,2020-02-01,"Fulton County, GA",549912
"1227","2020","M03","March",23458,567554,0.0413317499304031,2020-03-01,"Fulton County, GA",544096
"1228","2020","M04","April",75259,544238,0.138283251077654,2020-04-01,"Fulton County, GA",468979
"1229","2020","M05","May",64314,553654,0.116162802038818,2020-05-01,"Fulton County, GA",489340
"1230","2020","M06","June",61567,553863,0.111159257794798,2020-06-01,"Fulton County, GA",492296
"1231","2020","M07","July",57512,552710,0.104054567494708,2020-07-01,"Fulton County, GA",495198
"1232","2020","M08","August",50417,545746,0.0923818039894017,2020-08-01,"Fulton County, GA",495329
"1233","2020","M09","September",46235,544883,0.0848530785508082,2020-09-01,"Fulton County, GA",498648
"1234","2020","M10","October",39371,561387,0.070131656059011,2020-10-01,"Fulton County, GA",522016
"1235","2020","M11","November",38567,562908,0.0685138601689797,2020-11-01,"Fulton County, GA",524341
"1236","2020","M12","December",38814,563697,0.0688561407990463,2020-12-01,"Fulton County, GA",524883
"1237","2021","M01","January",34067,557307,0.0611278882195989,2021-01-01,"Fulton County, GA",523240
"1238","2021","M02","February",30224,562227,0.0537576459330484,2021-02-01,"Fulton County, GA",532003
"1239","2021","M03","March",27425,563933,0.0486316636905448,2021-03-01,"Fulton County, GA",536508
"1240","2021","M04","April",26831,565936,0.0474099544824857,2021-04-01,"Fulton County, GA",539105
"1241","2021","M05","May",26842,563255,0.0476551473133838,2021-05-01,"Fulton County, GA",536413
"1242","2021","M06","June",30483,568576,0.0536128855245385,2021-06-01,"Fulton County, GA",538093
"1243","2021","M07","July",21843,566865,0.03853298404382,2021-07-01,"Fulton County, GA",545022
"1244","2021","M08","August",20897,562091,0.0371772542168439,2021-08-01,"Fulton County, GA",541194
"1245","2021","M09","September",17015,563718,0.0301835314820531,2021-09-01,"Fulton County, GA",546703
"1246","2021","M10","October",16125,566069,0.0284859266273193,2021-10-01,"Fulton County, GA",549944
"1247","2021","M11","November",14309,568440,0.0251724016606854,2021-11-01,"Fulton County, GA",554131
"1248","2021","M12","December",15235,570466,0.0267062366556464,2021-12-01,"Fulton County, GA",555231
"1249","2020","M01","January",8536,180521,0.0472853573822436,2020-01-01,"Genesee County, MI",171985
"1250","2020","M02","February",7594,181229,0.0419027859779616,2020-02-01,"Genesee County, MI",173635
"1251","2020","M03","March",8815,179316,0.0491590265230097,2020-03-01,"Genesee County, MI",170501
"1252","2020","M04","April",53874,174414,0.308885754583921,2020-04-01,"Genesee County, MI",120540
"1253","2020","M05","May",46050,182612,0.25217400827985,2020-05-01,"Genesee County, MI",136562
"1254","2020","M06","June",26122,187952,0.138982293351494,2020-06-01,"Genesee County, MI",161830
"1255","2020","M07","July",18617,179117,0.103937649692659,2020-07-01,"Genesee County, MI",160500
"1256","2020","M08","August",15578,179730,0.0866744561286374,2020-08-01,"Genesee County, MI",164152
"1257","2020","M09","September",14312,177827,0.0804827163479112,2020-09-01,"Genesee County, MI",163515
"1258","2020","M10","October",12997,178038,0.0730012693919276,2020-10-01,"Genesee County, MI",165041
"1259","2020","M11","November",13494,179312,0.0752543053448737,2020-11-01,"Genesee County, MI",165818
"1260","2020","M12","December",14898,179125,0.0831709699930216,2020-12-01,"Genesee County, MI",164227
"1261","2021","M01","January",15078,177361,0.0850130524748958,2021-01-01,"Genesee County, MI",162283
"1262","2021","M02","February",12875,175320,0.0734371435090121,2021-02-01,"Genesee County, MI",162445
"1263","2021","M03","March",12458,175043,0.0711710836765823,2021-03-01,"Genesee County, MI",162585
"1264","2021","M04","April",11981,174536,0.0686448640968052,2021-04-01,"Genesee County, MI",162555
"1265","2021","M05","May",13259,177344,0.0747642998917358,2021-05-01,"Genesee County, MI",164085
"1266","2021","M06","June",13390,178754,0.0749074146592524,2021-06-01,"Genesee County, MI",165364
"1267","2021","M07","July",13179,177038,0.07444164529649,2021-07-01,"Genesee County, MI",163859
"1268","2021","M08","August",14377,174032,0.0826112439091661,2021-08-01,"Genesee County, MI",159655
"1269","2021","M09","September",14236,173150,0.0822177302916546,2021-09-01,"Genesee County, MI",158914
"1270","2021","M10","October",12163,171244,0.0710273060661979,2021-10-01,"Genesee County, MI",159081
"1271","2021","M11","November",11079,173252,0.0639473137395239,2021-11-01,"Genesee County, MI",162173
"1272","2021","M12","December",10584,173865,0.0608748166681046,2021-12-01,"Genesee County, MI",163281
"1273","2020","M01","January",6488,153027,0.0423977468028518,2020-01-01,"Gloucester County, NJ",146539
"1274","2020","M02","February",6260,154016,0.0406451277789321,2020-02-01,"Gloucester County, NJ",147756
"1275","2020","M03","March",6402,153148,0.041802700655575,2020-03-01,"Gloucester County, NJ",146746
"1276","2020","M04","April",24874,150868,0.164872603865631,2020-04-01,"Gloucester County, NJ",125994
"1277","2020","M05","May",24168,150679,0.160393950052761,2020-05-01,"Gloucester County, NJ",126511
"1278","2020","M06","June",23186,151734,0.152806885734245,2020-06-01,"Gloucester County, NJ",128548
"1279","2020","M07","July",19601,155935,0.12569981081861,2020-07-01,"Gloucester County, NJ",136334
"1280","2020","M08","August",15178,152209,0.0997181507006813,2020-08-01,"Gloucester County, NJ",137031
"1281","2020","M09","September",9883,145789,0.0677897509414291,2020-09-01,"Gloucester County, NJ",135906
"1282","2020","M10","October",9263,147004,0.0630118908329025,2020-10-01,"Gloucester County, NJ",137741
"1283","2020","M11","November",13215,150959,0.0875403255188495,2020-11-01,"Gloucester County, NJ",137744
"1284","2020","M12","December",9819,147587,0.0665302499542643,2020-12-01,"Gloucester County, NJ",137768
"1285","2021","M01","January",11184,147630,0.0757569599674863,2021-01-01,"Gloucester County, NJ",136446
"1286","2021","M02","February",11875,148999,0.079698521466587,2021-02-01,"Gloucester County, NJ",137124
"1287","2021","M03","March",11211,150656,0.0744145603228547,2021-03-01,"Gloucester County, NJ",139445
"1288","2021","M04","April",9918,148852,0.0666299411495983,2021-04-01,"Gloucester County, NJ",138934
"1289","2021","M05","May",9910,149050,0.0664877557866488,2021-05-01,"Gloucester County, NJ",139140
"1290","2021","M06","June",11900,150964,0.0788267401499695,2021-06-01,"Gloucester County, NJ",139064
"1291","2021","M07","July",11292,151528,0.0745208806293226,2021-07-01,"Gloucester County, NJ",140236
"1292","2021","M08","August",10164,150535,0.0675191815856778,2021-08-01,"Gloucester County, NJ",140371
"1293","2021","M09","September",8691,149147,0.0582713698565844,2021-09-01,"Gloucester County, NJ",140456
"1294","2021","M10","October",7632,151511,0.0503725802086977,2021-10-01,"Gloucester County, NJ",143879
"1295","2021","M11","November",7502,152020,0.0493487698986975,2021-11-01,"Gloucester County, NJ",144518
"1296","2021","M12","December",7108,153190,0.0463998955545401,2021-12-01,"Gloucester County, NJ",146082
"1297","2020","M01","January",5741,146458,0.0391989512351664,2020-01-01,"Greensboro, NC",140717
"1298","2020","M02","February",5431,147642,0.0367849256986494,2020-02-01,"Greensboro, NC",142211
"1299","2020","M03","March",6062,141487,0.0428449256822182,2020-03-01,"Greensboro, NC",135425
"1300","2020","M04","April",21547,136890,0.157403754839652,2020-04-01,"Greensboro, NC",115343
"1301","2020","M05","May",24007,142657,0.168284766958509,2020-05-01,"Greensboro, NC",118650
"1302","2020","M06","June",16415,141815,0.115749391813278,2020-06-01,"Greensboro, NC",125400
"1303","2020","M07","July",17823,144842,0.123051324891951,2020-07-01,"Greensboro, NC",127019
"1304","2020","M08","August",13129,143070,0.0917662682602922,2020-08-01,"Greensboro, NC",129941
"1305","2020","M09","September",13495,146171,0.0923233746776036,2020-09-01,"Greensboro, NC",132676
"1306","2020","M10","October",12158,145989,0.0832802471419079,2020-10-01,"Greensboro, NC",133831
"1307","2020","M11","November",11601,144813,0.0801102110998322,2020-11-01,"Greensboro, NC",133212
"1308","2020","M12","December",10906,143981,0.0757461053889055,2020-12-01,"Greensboro, NC",133075
"1309","2021","M01","January",10457,143572,0.0728345359819463,2021-01-01,"Greensboro, NC",133115
"1310","2021","M02","February",9826,143840,0.0683120133481646,2021-02-01,"Greensboro, NC",134014
"1311","2021","M03","March",8036,143215,0.0561114408406941,2021-03-01,"Greensboro, NC",135179
"1312","2021","M04","April",7665,142549,0.053770984012515,2021-04-01,"Greensboro, NC",134884
"1313","2021","M05","May",7881,141933,0.0555261989812094,2021-05-01,"Greensboro, NC",134052
"1314","2021","M06","June",8569,142919,0.0599570386022852,2021-06-01,"Greensboro, NC",134350
"1315","2021","M07","July",8270,141739,0.0583466794601345,2021-07-01,"Greensboro, NC",133469
"1316","2021","M08","August",7757,141986,0.0546321468313777,2021-08-01,"Greensboro, NC",134229
"1317","2021","M09","September",6664,143683,0.0463798779257115,2021-09-01,"Greensboro, NC",137019
"1318","2021","M10","October",6645,144228,0.0460728845993843,2021-10-01,"Greensboro, NC",137583
"1319","2021","M11","November",6061,143503,0.0422360508142687,2021-11-01,"Greensboro, NC",137442
"1320","2021","M12","December",5854,144069,0.0406333076511949,2021-12-01,"Greensboro, NC",138215
"1321","2020","M01","January",18844,417926,0.0450893220330872,2020-01-01,"Hamilton County, OH",399082
"1322","2020","M02","February",17593,419233,0.0419647308298726,2020-02-01,"Hamilton County, OH",401640
"1323","2020","M03","March",20856,419706,0.0496919272061872,2020-03-01,"Hamilton County, OH",398850
"1324","2020","M04","April",53153,389404,0.136498341054535,2020-04-01,"Hamilton County, OH",336251
"1325","2020","M05","May",56748,416978,0.136093510928634,2020-05-01,"Hamilton County, OH",360230
"1326","2020","M06","June",42805,416532,0.102765213717073,2020-06-01,"Hamilton County, OH",373727
"1327","2020","M07","July",43806,425105,0.103047482386704,2020-07-01,"Hamilton County, OH",381299
"1328","2020","M08","August",41427,430637,0.0961993511936968,2020-08-01,"Hamilton County, OH",389210
"1329","2020","M09","September",32614,420087,0.0776362991475575,2020-09-01,"Hamilton County, OH",387473
"1330","2020","M10","October",20363,412945,0.0493116516727409,2020-10-01,"Hamilton County, OH",392582
"1331","2020","M11","November",19391,411583,0.0471132189619105,2020-11-01,"Hamilton County, OH",392192
"1332","2020","M12","December",20068,410248,0.0489167527934323,2020-12-01,"Hamilton County, OH",390180
"1333","2021","M01","January",23965,410419,0.0583915462003465,2021-01-01,"Hamilton County, OH",386454
"1334","2021","M02","February",22665,412212,0.054983843265116,2021-02-01,"Hamilton County, OH",389547
"1335","2021","M03","March",18088,412640,0.0438348196975572,2021-03-01,"Hamilton County, OH",394552
"1336","2021","M04","April",19371,418045,0.0463371168175675,2021-04-01,"Hamilton County, OH",398674
"1337","2021","M05","May",19380,399236,0.0485427165886844,2021-05-01,"Hamilton County, OH",379856
"1338","2021","M06","June",24917,409293,0.0608781484169043,2021-06-01,"Hamilton County, OH",384376
"1339","2021","M07","July",24428,413319,0.0591020495065555,2021-07-01,"Hamilton County, OH",388891
"1340","2021","M08","August",21015,417815,0.0502973804195637,2021-08-01,"Hamilton County, OH",396800
"1341","2021","M09","September",18094,415262,0.0435724915836267,2021-09-01,"Hamilton County, OH",397168
"1342","2021","M10","October",15766,416934,0.0378141384487713,2021-10-01,"Hamilton County, OH",401168
"1343","2021","M11","November",13749,415629,0.0330799823881394,2021-11-01,"Hamilton County, OH",401880
"1344","2021","M12","December",12460,415496,0.0299882550012515,2021-12-01,"Hamilton County, OH",403036
"1345","2020","M01","January",4878,144191,0.0338301280939865,2020-01-01,"Harford County, MD",139313
"1346","2020","M02","February",4746,144476,0.0328497466707273,2020-02-01,"Harford County, MD",139730
"1347","2020","M03","March",5204,144171,0.0360960248593684,2020-03-01,"Harford County, MD",138967
"1348","2020","M04","April",12007,136354,0.0880575560672954,2020-04-01,"Harford County, MD",124347
"1349","2020","M05","May",11739,136631,0.085917544334741,2020-05-01,"Harford County, MD",124892
"1350","2020","M06","June",10394,141878,0.0732601248960374,2020-06-01,"Harford County, MD",131484
"1351","2020","M07","July",10253,138251,0.07416221220823,2020-07-01,"Harford County, MD",127998
"1352","2020","M08","August",9549,137049,0.0696758093820458,2020-08-01,"Harford County, MD",127500
"1353","2020","M09","September",7010,130123,0.0538721056231412,2020-09-01,"Harford County, MD",123113
"1354","2020","M10","October",6525,135032,0.0483218792582499,2020-10-01,"Harford County, MD",128507
"1355","2020","M11","November",6691,135934,0.0492224167610752,2020-11-01,"Harford County, MD",129243
"1356","2020","M12","December",7013,135950,0.0515851415961751,2020-12-01,"Harford County, MD",128937
"1357","2021","M01","January",6939,134766,0.0514892480299185,2021-01-01,"Harford County, MD",127827
"1358","2021","M02","February",6850,134962,0.0507550273410293,2021-02-01,"Harford County, MD",128112
"1359","2021","M03","March",6833,136043,0.0502267665370508,2021-03-01,"Harford County, MD",129210
"1360","2021","M04","April",6334,135990,0.0465769541878079,2021-04-01,"Harford County, MD",129656
"1361","2021","M05","May",6545,136145,0.0480737449043299,2021-05-01,"Harford County, MD",129600
"1362","2021","M06","June",7883,138428,0.0569465715028751,2021-06-01,"Harford County, MD",130545
"1363","2021","M07","July",6774,139783,0.0484608285699978,2021-07-01,"Harford County, MD",133009
"1364","2021","M08","August",6769,137951,0.0490681473856659,2021-08-01,"Harford County, MD",131182
"1365","2021","M09","September",6223,136905,0.0454548774697783,2021-09-01,"Harford County, MD",130682
"1366","2021","M10","October",5773,137209,0.0420744994861853,2021-10-01,"Harford County, MD",131436
"1367","2021","M11","November",5190,137464,0.0377553395798173,2021-11-01,"Harford County, MD",132274
"1368","2021","M12","December",4638,137428,0.0337485810751812,2021-12-01,"Harford County, MD",132790
"1369","2020","M01","January",94984,2320335,0.040935468369869,2020-01-01,"Harris County, TX",2225351
"1370","2020","M02","February",90342,2341158,0.0385885958999777,2020-02-01,"Harris County, TX",2250816
"1371","2020","M03","March",128091,2291312,0.0559029062825141,2020-03-01,"Harris County, TX",2163221
"1372","2020","M04","April",319747,2211506,0.1445833744064,2020-04-01,"Harris County, TX",1891759
"1373","2020","M05","May",303953,2251609,0.134993686736907,2020-05-01,"Harris County, TX",1947656
"1374","2020","M06","June",281214,2330137,0.12068560775611,2020-06-01,"Harris County, TX",2048923
"1375","2020","M07","July",267441,2308172,0.115867015109793,2020-07-01,"Harris County, TX",2040731
"1376","2020","M08","August",195235,2299091,0.0849183438150121,2020-08-01,"Harris County, TX",2103856
"1377","2020","M09","September",224050,2289765,0.0978484691660498,2020-09-01,"Harris County, TX",2065715
"1378","2020","M10","October",188590,2302954,0.0818904763186759,2020-10-01,"Harris County, TX",2114364
"1379","2020","M11","November",181400,2277042,0.079664758050137,2020-11-01,"Harris County, TX",2095642
"1380","2020","M12","December",176678,2290029,0.0771509880442562,2020-12-01,"Harris County, TX",2113351
"1381","2021","M01","January",187163,2265542,0.0826129023430155,2021-01-01,"Harris County, TX",2078379
"1382","2021","M02","February",190442,2266569,0.0840221497779243,2021-02-01,"Harris County, TX",2076127
"1383","2021","M03","March",182767,2279958,0.0801624415888363,2021-03-01,"Harris County, TX",2097191
"1384","2021","M04","April",165515,2283561,0.0724810942208244,2021-04-01,"Harris County, TX",2118046
"1385","2021","M05","May",153047,2287864,0.0668951476136693,2021-05-01,"Harris County, TX",2134817
"1386","2021","M06","June",169857,2294861,0.0740162476071535,2021-06-01,"Harris County, TX",2125004
"1387","2021","M07","July",157792,2311102,0.0682756537790197,2021-07-01,"Harris County, TX",2153310
"1388","2021","M08","August",141348,2304932,0.0613241518621808,2021-08-01,"Harris County, TX",2163584
"1389","2021","M09","September",128978,2308875,0.0558618374749607,2021-09-01,"Harris County, TX",2179897
"1390","2021","M10","October",124506,2316532,0.05374672139215,2021-10-01,"Harris County, TX",2192026
"1391","2021","M11","November",119873,2336150,0.0513122016993772,2021-11-01,"Harris County, TX",2216277
"1392","2021","M12","December",113162,2338707,0.0483865657391028,2021-12-01,"Harris County, TX",2225545
"1393","2020","M01","January",6164,171933,0.035851174585449,2020-01-01,"Henderson, NV",165769
"1394","2020","M02","February",5768,173739,0.0331992241235416,2020-02-01,"Henderson, NV",167971
"1395","2020","M03","March",10510,170331,0.0617033892832191,2020-03-01,"Henderson, NV",159821
"1396","2020","M04","April",43515,152209,0.285889796266975,2020-04-01,"Henderson, NV",108694
"1397","2020","M05","May",33654,145752,0.230899061419397,2020-05-01,"Henderson, NV",112098
"1398","2020","M06","June",22757,154768,0.147039439677453,2020-06-01,"Henderson, NV",132011
"1399","2020","M07","July",25561,157682,0.162104742456336,2020-07-01,"Henderson, NV",132121
"1400","2020","M08","August",22025,158842,0.138659800304705,2020-08-01,"Henderson, NV",136817
"1401","2020","M09","September",20262,160619,0.126149459279413,2020-09-01,"Henderson, NV",140357
"1402","2020","M10","October",18580,161718,0.114891354085507,2020-10-01,"Henderson, NV",143138
"1403","2020","M11","November",13163,158818,0.0828810336359858,2020-11-01,"Henderson, NV",145655
"1404","2020","M12","December",12645,158563,0.0797474820733715,2020-12-01,"Henderson, NV",145918
"1405","2021","M01","January",13113,159932,0.0819910962158917,2021-01-01,"Henderson, NV",146819
"1406","2021","M02","February",12635,162234,0.0778813319033002,2021-02-01,"Henderson, NV",149599
"1407","2021","M03","March",12006,161922,0.0741468114277245,2021-03-01,"Henderson, NV",149916
"1408","2021","M04","April",12552,162570,0.0772098173094667,2021-04-01,"Henderson, NV",150018
"1409","2021","M05","May",12301,164407,0.0748204151891343,2021-05-01,"Henderson, NV",152106
"1410","2021","M06","June",13258,164300,0.0806938527084601,2021-06-01,"Henderson, NV",151042
"1411","2021","M07","July",13186,163997,0.0804039098276188,2021-07-01,"Henderson, NV",150811
"1412","2021","M08","August",11548,162655,0.0709968952691279,2021-08-01,"Henderson, NV",151107
"1413","2021","M09","September",9699,162012,0.0598659358566032,2021-09-01,"Henderson, NV",152313
"1414","2021","M10","October",8863,163723,0.0541341167703988,2021-10-01,"Henderson, NV",154860
"1415","2021","M11","November",8264,163280,0.0506124448799608,2021-11-01,"Henderson, NV",155016
"1416","2021","M12","December",8039,162917,0.0493441445644101,2021-12-01,"Henderson, NV",154878
"1417","2020","M01","January",18173,710825,0.0255660675975099,2020-01-01,"Hennepin County, MN",692652
"1418","2020","M02","February",18437,715593,0.0257646455457222,2020-02-01,"Hennepin County, MN",697156
"1419","2020","M03","March",24934,713580,0.0349421228173435,2020-03-01,"Hennepin County, MN",688646
"1420","2020","M04","April",64937,685892,0.0946752549964134,2020-04-01,"Hennepin County, MN",620955
"1421","2020","M05","May",87135,709674,0.122781727948326,2020-05-01,"Hennepin County, MN",622539
"1422","2020","M06","June",74605,736431,0.101306164460757,2020-06-01,"Hennepin County, MN",661826
"1423","2020","M07","July",66078,731468,0.0903361459421328,2020-07-01,"Hennepin County, MN",665390
"1424","2020","M08","August",55178,724540,0.076155905816104,2020-08-01,"Hennepin County, MN",669362
"1425","2020","M09","September",48156,712193,0.0676165028299913,2020-09-01,"Hennepin County, MN",664037
"1426","2020","M10","October",37191,699714,0.0531517162726485,2020-10-01,"Hennepin County, MN",662523
"1427","2020","M11","November",31269,695696,0.0449463558795796,2020-11-01,"Hennepin County, MN",664427
"1428","2020","M12","December",32290,687635,0.0469580518734503,2020-12-01,"Hennepin County, MN",655345
"1429","2021","M01","January",30635,679745,0.0450683712274456,2021-01-01,"Hennepin County, MN",649110
"1430","2021","M02","February",29535,686305,0.0430348023109259,2021-02-01,"Hennepin County, MN",656770
"1431","2021","M03","March",28327,688324,0.0411535846490897,2021-03-01,"Hennepin County, MN",659997
"1432","2021","M04","April",29426,694957,0.0423421880778235,2021-04-01,"Hennepin County, MN",665531
"1433","2021","M05","May",27915,699543,0.0399046234470218,2021-05-01,"Hennepin County, MN",671628
"1434","2021","M06","June",33216,700338,0.0474285273682136,2021-06-01,"Hennepin County, MN",667122
"1435","2021","M07","July",25929,700346,0.0370231285678793,2021-07-01,"Hennepin County, MN",674417
"1436","2021","M08","August",25329,697625,0.036307471779251,2021-08-01,"Hennepin County, MN",672296
"1437","2021","M09","September",21964,696141,0.0315510794508584,2021-09-01,"Hennepin County, MN",674177
"1438","2021","M10","October",18910,691195,0.0273584154977973,2021-10-01,"Hennepin County, MN",672285
"1439","2021","M11","November",15540,694066,0.0223898015462506,2021-11-01,"Hennepin County, MN",678526
"1440","2021","M12","December",16816,690128,0.0243664943314863,2021-12-01,"Hennepin County, MN",673312
"1441","2020","M01","January",6693,142402,0.0470007443715678,2020-01-01,"Horry County, SC",135709
"1442","2020","M02","February",6070,143855,0.0421952660665253,2020-02-01,"Horry County, SC",137785
"1443","2020","M03","March",5929,144583,0.0410075873373771,2020-03-01,"Horry County, SC",138654
"1444","2020","M04","April",29257,145564,0.200990629551263,2020-04-01,"Horry County, SC",116307
"1445","2020","M05","May",25621,149336,0.171566132747629,2020-05-01,"Horry County, SC",123715
"1446","2020","M06","June",15337,155131,0.0988648303691719,2020-06-01,"Horry County, SC",139794
"1447","2020","M07","July",15053,157751,0.0954225329791887,2020-07-01,"Horry County, SC",142698
"1448","2020","M08","August",10099,151884,0.0664915330120355,2020-08-01,"Horry County, SC",141785
"1449","2020","M09","September",9307,149555,0.0622312861489084,2020-09-01,"Horry County, SC",140248
"1450","2020","M10","October",9087,148734,0.0610956472628989,2020-10-01,"Horry County, SC",139647
"1451","2020","M11","November",9521,141746,0.0671694439349259,2020-11-01,"Horry County, SC",132225
"1452","2020","M12","December",10916,141825,0.0769680944826371,2020-12-01,"Horry County, SC",130909
"1453","2021","M01","January",10235,141453,0.0723561889814992,2021-01-01,"Horry County, SC",131218
"1454","2021","M02","February",10180,144265,0.0705645860049215,2021-02-01,"Horry County, SC",134085
"1455","2021","M03","March",9179,146980,0.0624506735610287,2021-03-01,"Horry County, SC",137801
"1456","2021","M04","April",8122,148524,0.0546847647518246,2021-04-01,"Horry County, SC",140402
"1457","2021","M05","May",6657,150050,0.0443652115961346,2021-05-01,"Horry County, SC",143393
"1458","2021","M06","June",8297,154731,0.0536220925347862,2021-06-01,"Horry County, SC",146434
"1459","2021","M07","July",7909,156388,0.0505729339847047,2021-07-01,"Horry County, SC",148479
"1460","2021","M08","August",7830,153502,0.0510091073731938,2021-08-01,"Horry County, SC",145672
"1461","2021","M09","September",5926,149535,0.039629518173003,2021-09-01,"Horry County, SC",143609
"1462","2021","M10","October",5649,149044,0.0379015592710877,2021-10-01,"Horry County, SC",143395
"1463","2021","M11","November",5656,146672,0.0385622341005782,2021-11-01,"Horry County, SC",141016
"1464","2021","M12","December",6491,146326,0.0443598540245753,2021-12-01,"Horry County, SC",139835
"1465","2020","M01","January",45248,1152936,0.0392458904917532,2020-01-01,"Houston, TX",1107688
"1466","2020","M02","February",43432,1163794,0.0373193193984502,2020-02-01,"Houston, TX",1120362
"1467","2020","M03","March",62341,1139108,0.0547279099084547,2020-03-01,"Houston, TX",1076767
"1468","2020","M04","April",158535,1100192,0.144097575695879,2020-04-01,"Houston, TX",941657
"1469","2020","M05","May",150788,1120257,0.134601256675923,2020-05-01,"Houston, TX",969469
"1470","2020","M06","June",140388,1160259,0.120997122194269,2020-06-01,"Houston, TX",1019871
"1471","2020","M07","July",133197,1148981,0.115926198953682,2020-07-01,"Houston, TX",1015784
"1472","2020","M08","August",97013,1144211,0.0847859354612043,2020-08-01,"Houston, TX",1047198
"1473","2020","M09","September",110303,1138523,0.096882539922338,2020-09-01,"Houston, TX",1028220
"1474","2020","M10","October",92159,1144603,0.0805161265521757,2020-10-01,"Houston, TX",1052444
"1475","2020","M11","November",88363,1131490,0.0780943711389407,2020-11-01,"Houston, TX",1043127
"1476","2020","M12","December",85955,1137893,0.0755387369462682,2020-12-01,"Houston, TX",1051938
"1477","2021","M01","January",90313,1124844,0.0802893556795431,2021-01-01,"Houston, TX",1034531
"1478","2021","M02","February",92975,1126385,0.0825428250553763,2021-02-01,"Houston, TX",1033410
"1479","2021","M03","March",91083,1134968,0.0802516018072756,2021-03-01,"Houston, TX",1043885
"1480","2021","M04","April",81392,1135662,0.0716692114379102,2021-04-01,"Houston, TX",1054270
"1481","2021","M05","May",74865,1137476,0.0658167732769746,2021-05-01,"Houston, TX",1062611
"1482","2021","M06","June",82608,1140335,0.0724418701521921,2021-06-01,"Houston, TX",1057727
"1483","2021","M07","July",77169,1148970,0.0671636335152354,2021-07-01,"Houston, TX",1071801
"1484","2021","M08","August",69064,1145977,0.0602664800427932,2021-08-01,"Houston, TX",1076913
"1485","2021","M09","September",62777,1147814,0.0546926592636089,2021-09-01,"Houston, TX",1085037
"1486","2021","M10","October",60511,1151592,0.052545519593745,2021-10-01,"Houston, TX",1091081
"1487","2021","M11","November",58110,1161263,0.0500403440047603,2021-11-01,"Houston, TX",1103153
"1488","2021","M12","December",53803,1161569,0.0463192457787699,2021-12-01,"Houston, TX",1107766
"1489","2020","M01","January",4498,150854,0.0298169090643934,2020-01-01,"Ingham County, MI",146356
"1490","2020","M02","February",4287,152968,0.0280254693792166,2020-02-01,"Ingham County, MI",148681
"1491","2020","M03","March",5103,151779,0.033621251951851,2020-03-01,"Ingham County, MI",146676
"1492","2020","M04","April",25126,139156,0.180559947109719,2020-04-01,"Ingham County, MI",114030
"1493","2020","M05","May",23201,147983,0.156781522201875,2020-05-01,"Ingham County, MI",124782
"1494","2020","M06","June",14753,151304,0.0975056839211125,2020-06-01,"Ingham County, MI",136551
"1495","2020","M07","July",11128,143174,0.07772360903516,2020-07-01,"Ingham County, MI",132046
"1496","2020","M08","August",9391,144183,0.0651325052190619,2020-08-01,"Ingham County, MI",134792
"1497","2020","M09","September",8728,144394,0.060445724891616,2020-09-01,"Ingham County, MI",135666
"1498","2020","M10","October",8022,145621,0.0550882084314762,2020-10-01,"Ingham County, MI",137599
"1499","2020","M11","November",8213,146465,0.0560748301642031,2020-11-01,"Ingham County, MI",138252
"1500","2020","M12","December",8997,145639,0.0617760352652792,2020-12-01,"Ingham County, MI",136642
"1501","2021","M01","January",8564,143187,0.0598098989433398,2021-01-01,"Ingham County, MI",134623
"1502","2021","M02","February",7376,143136,0.0515314106863403,2021-02-01,"Ingham County, MI",135760
"1503","2021","M03","March",7544,143285,0.0526503123146177,2021-03-01,"Ingham County, MI",135741
"1504","2021","M04","April",7975,142116,0.056116130484956,2021-04-01,"Ingham County, MI",134141
"1505","2021","M05","May",8502,143514,0.0592416070905974,2021-05-01,"Ingham County, MI",135012
"1506","2021","M06","June",8438,143632,0.0587473543500056,2021-06-01,"Ingham County, MI",135194
"1507","2021","M07","July",8185,144189,0.0567657727011076,2021-07-01,"Ingham County, MI",136004
"1508","2021","M08","August",7916,142334,0.055615664563632,2021-08-01,"Ingham County, MI",134418
"1509","2021","M09","September",9298,144534,0.064330884082638,2021-09-01,"Ingham County, MI",135236
"1510","2021","M10","October",6892,144134,0.0478166150942873,2021-10-01,"Ingham County, MI",137242
"1511","2021","M11","November",6010,145031,0.0414394164006316,2021-11-01,"Ingham County, MI",139021
"1512","2021","M12","December",5805,144140,0.0402733453586791,2021-12-01,"Ingham County, MI",138335
"1513","2020","M01","January",17411,464902,0.0374509036313029,2020-01-01,"Jacksonville city, FL",447491
"1514","2020","M02","February",15772,466300,0.0338237186360712,2020-02-01,"Jacksonville city, FL",450528
"1515","2020","M03","March",26401,472351,0.0558927577161899,2020-03-01,"Jacksonville city, FL",445950
"1516","2020","M04","April",51957,433578,0.119833109613495,2020-04-01,"Jacksonville city, FL",381621
"1517","2020","M05","May",53321,449248,0.118689454377092,2020-05-01,"Jacksonville city, FL",395927
"1518","2020","M06","June",43583,450779,0.0966837408131257,2020-06-01,"Jacksonville city, FL",407196
"1519","2020","M07","July",47262,463109,0.102053728171985,2020-07-01,"Jacksonville city, FL",415847
"1520","2020","M08","August",32933,457948,0.0719142784770323,2020-08-01,"Jacksonville city, FL",425015
"1521","2020","M09","September",27518,462740,0.0594675195574189,2020-09-01,"Jacksonville city, FL",435222
"1522","2020","M10","October",22625,460801,0.0490992858088416,2020-10-01,"Jacksonville city, FL",438176
"1523","2020","M11","November",19912,460549,0.0432353560641756,2020-11-01,"Jacksonville city, FL",440637
"1524","2020","M12","December",16320,459202,0.035539914895841,2020-12-01,"Jacksonville city, FL",442882
"1525","2021","M01","January",21339,461808,0.0462075148113502,2021-01-01,"Jacksonville city, FL",440469
"1526","2021","M02","February",22051,466021,0.0473176101506155,2021-02-01,"Jacksonville city, FL",443970
"1527","2021","M03","March",23005,471112,0.0488312757900457,2021-03-01,"Jacksonville city, FL",448107
"1528","2021","M04","April",23544,476058,0.0494561587033513,2021-04-01,"Jacksonville city, FL",452514
"1529","2021","M05","May",23113,481629,0.0479892199182358,2021-05-01,"Jacksonville city, FL",458516
"1530","2021","M06","June",27112,490208,0.0553071349304785,2021-06-01,"Jacksonville city, FL",463096
"1531","2021","M07","July",24538,492080,0.0498658754674037,2021-07-01,"Jacksonville city, FL",467542
"1532","2021","M08","August",23156,489234,0.0473311339767882,2021-08-01,"Jacksonville city, FL",466078
"1533","2021","M09","September",20165,489084,0.0412301363364984,2021-09-01,"Jacksonville city, FL",468919
"1534","2021","M10","October",20023,490497,0.0408218602764135,2021-10-01,"Jacksonville city, FL",470474
"1535","2021","M11","November",18185,489814,0.037126337752698,2021-11-01,"Jacksonville city, FL",471629
"1536","2021","M12","December",17408,489301,0.03557728269511,2021-12-01,"Jacksonville city, FL",471893
"1537","2020","M01","January",8854,336534,0.0263093773586027,2020-01-01,"Jefferson County, CO",327680
"1538","2020","M02","February",8747,337920,0.0258848248106061,2020-02-01,"Jefferson County, CO",329173
"1539","2020","M03","March",14981,329511,0.0454643395819866,2020-03-01,"Jefferson County, CO",314530
"1540","2020","M04","April",38781,318333,0.121825258455768,2020-04-01,"Jefferson County, CO",279552
"1541","2020","M05","May",38776,330727,0.11724473659544,2020-05-01,"Jefferson County, CO",291951
"1542","2020","M06","June",38122,339439,0.112308838996108,2020-06-01,"Jefferson County, CO",301317
"1543","2020","M07","July",24344,329512,0.0738789482628857,2020-07-01,"Jefferson County, CO",305168
"1544","2020","M08","August",23095,334018,0.069142980318426,2020-08-01,"Jefferson County, CO",310923
"1545","2020","M09","September",22269,336402,0.0661975850321936,2020-09-01,"Jefferson County, CO",314133
"1546","2020","M10","October",21404,335360,0.0638239503816794,2020-10-01,"Jefferson County, CO",313956
"1547","2020","M11","November",21590,339074,0.0636734164223739,2020-11-01,"Jefferson County, CO",317484
"1548","2020","M12","December",22532,337351,0.0667909684571855,2020-12-01,"Jefferson County, CO",314819
"1549","2021","M01","January",22470,338083,0.0664629691525454,2021-01-01,"Jefferson County, CO",315613
"1550","2021","M02","February",21548,339786,0.0634163856074117,2021-02-01,"Jefferson County, CO",318238
"1551","2021","M03","March",21396,337631,0.0633709582354701,2021-03-01,"Jefferson County, CO",316235
"1552","2021","M04","April",20346,341060,0.059655192634727,2021-04-01,"Jefferson County, CO",320714
"1553","2021","M05","May",18480,340427,0.0542847658969471,2021-05-01,"Jefferson County, CO",321947
"1554","2021","M06","June",20001,342579,0.0583836137066195,2021-06-01,"Jefferson County, CO",322578
"1555","2021","M07","July",18726,341337,0.0548607388006574,2021-07-01,"Jefferson County, CO",322611
"1556","2021","M08","August",16982,341961,0.0496606338149672,2021-08-01,"Jefferson County, CO",324979
"1557","2021","M09","September",14876,345223,0.0430909875645597,2021-09-01,"Jefferson County, CO",330347
"1558","2021","M10","October",14150,344713,0.0410486404632259,2021-10-01,"Jefferson County, CO",330563
"1559","2021","M11","November",14085,346138,0.0406918627830518,2021-11-01,"Jefferson County, CO",332053
"1560","2021","M12","December",13128,345142,0.0380365183026117,2021-12-01,"Jefferson County, CO",332014
"1561","2020","M01","January",6780,106459,0.0636864896345072,2020-01-01,"Jefferson County, TX",99679
"1562","2020","M02","February",6141,107033,0.0573748283239748,2020-02-01,"Jefferson County, TX",100892
"1563","2020","M03","March",8962,105821,0.0846901843679421,2020-03-01,"Jefferson County, TX",96859
"1564","2020","M04","April",18997,103355,0.183803396062116,2020-04-01,"Jefferson County, TX",84358
"1565","2020","M05","May",18184,104024,0.174805814042913,2020-05-01,"Jefferson County, TX",85840
"1566","2020","M06","June",16626,106561,0.156023310592055,2020-06-01,"Jefferson County, TX",89935
"1567","2020","M07","July",15573,105980,0.146942819399887,2020-07-01,"Jefferson County, TX",90407
"1568","2020","M08","August",11408,105107,0.10853701466125,2020-08-01,"Jefferson County, TX",93699
"1569","2020","M09","September",13428,105247,0.127585584387203,2020-09-01,"Jefferson County, TX",91819
"1570","2020","M10","October",11520,106166,0.108509315600098,2020-10-01,"Jefferson County, TX",94646
"1571","2020","M11","November",11562,105401,0.109695353934023,2020-11-01,"Jefferson County, TX",93839
"1572","2020","M12","December",11661,105955,0.110056155915247,2020-12-01,"Jefferson County, TX",94294
"1573","2021","M01","January",12937,105875,0.122191263282172,2021-01-01,"Jefferson County, TX",92938
"1574","2021","M02","February",13390,106564,0.125652190233099,2021-02-01,"Jefferson County, TX",93174
"1575","2021","M03","March",12208,106596,0.114525873391122,2021-03-01,"Jefferson County, TX",94388
"1576","2021","M04","April",11428,106272,0.107535380909365,2021-04-01,"Jefferson County, TX",94844
"1577","2021","M05","May",10919,106622,0.102408508562961,2021-05-01,"Jefferson County, TX",95703
"1578","2021","M06","June",11907,107059,0.111219047441131,2021-06-01,"Jefferson County, TX",95152
"1579","2021","M07","July",11033,106389,0.103704330334903,2021-07-01,"Jefferson County, TX",95356
"1580","2021","M08","August",9817,106346,0.092311887612134,2021-08-01,"Jefferson County, TX",96529
"1581","2021","M09","September",8835,106192,0.0831983576917282,2021-09-01,"Jefferson County, TX",97357
"1582","2021","M10","October",8402,106493,0.0788972045110946,2021-10-01,"Jefferson County, TX",98091
"1583","2021","M11","November",8284,107144,0.077316508623908,2021-11-01,"Jefferson County, TX",98860
"1584","2021","M12","December",8121,107193,0.0757605440653774,2021-12-01,"Jefferson County, TX",99072
"1585","2020","M01","January",12217,269045,0.0454087606162538,2020-01-01,"Kane County, IL",256828
"1586","2020","M02","February",11237,267986,0.0419312949183913,2020-02-01,"Kane County, IL",256749
"1587","2020","M03","March",12284,263525,0.0466141732283465,2020-03-01,"Kane County, IL",251241
"1588","2020","M04","April",42625,248850,0.171287924452481,2020-04-01,"Kane County, IL",206225
"1589","2020","M05","May",40538,254094,0.159539383062961,2020-05-01,"Kane County, IL",213556
"1590","2020","M06","June",37414,267105,0.140072256228824,2020-06-01,"Kane County, IL",229691
"1591","2020","M07","July",31855,259960,0.122538082781966,2020-07-01,"Kane County, IL",228105
"1592","2020","M08","August",25180,266632,0.09443727684599,2020-08-01,"Kane County, IL",241452
"1593","2020","M09","September",20792,263418,0.0789315840223523,2020-09-01,"Kane County, IL",242626
"1594","2020","M10","October",17478,270021,0.0647282989100848,2020-10-01,"Kane County, IL",252543
"1595","2020","M11","November",16359,255310,0.0640750460224825,2020-11-01,"Kane County, IL",238951
"1596","2020","M12","December",18948,253832,0.0746477985439188,2020-12-01,"Kane County, IL",234884
"1597","2021","M01","January",21012,253636,0.0828431295242,2021-01-01,"Kane County, IL",232624
"1598","2021","M02","February",17587,251342,0.0699723882200348,2021-02-01,"Kane County, IL",233755
"1599","2021","M03","March",17874,250790,0.0712707843215439,2021-03-01,"Kane County, IL",232916
"1600","2021","M04","April",16077,251390,0.0639524245196706,2021-04-01,"Kane County, IL",235313
"1601","2021","M05","May",13268,250279,0.0530128376731568,2021-05-01,"Kane County, IL",237011
"1602","2021","M06","June",15944,256591,0.0621377990654388,2021-06-01,"Kane County, IL",240647
"1603","2021","M07","July",14587,260887,0.0559130964747189,2021-07-01,"Kane County, IL",246300
"1604","2021","M08","August",15586,256247,0.0608241267214836,2021-08-01,"Kane County, IL",240661
"1605","2021","M09","September",11383,256413,0.0443932249924926,2021-09-01,"Kane County, IL",245030
"1606","2021","M10","October",11384,255129,0.0446205644987438,2021-10-01,"Kane County, IL",243745
"1607","2021","M11","November",11258,260792,0.0431685021012915,2021-11-01,"Kane County, IL",249534
"1608","2021","M12","December",11308,255929,0.0441841291920806,2021-12-01,"Kane County, IL",244621
"1609","2020","M01","January",9851,260208,0.0378581749984628,2020-01-01,"Kansas City, MO",250357
"1610","2020","M02","February",9935,260845,0.0380877532634323,2020-02-01,"Kansas City, MO",250910
"1611","2020","M03","March",12022,261058,0.0460510691110788,2020-03-01,"Kansas City, MO",249036
"1612","2020","M04","April",36760,252858,0.145378038266537,2020-04-01,"Kansas City, MO",216098
"1613","2020","M05","May",30172,248225,0.121551012186524,2020-05-01,"Kansas City, MO",218053
"1614","2020","M06","June",24505,258308,0.0948673676386329,2020-06-01,"Kansas City, MO",233803
"1615","2020","M07","July",24618,271928,0.0905313171133535,2020-07-01,"Kansas City, MO",247310
"1616","2020","M08","August",20520,265801,0.0772006124882901,2020-08-01,"Kansas City, MO",245281
"1617","2020","M09","September",16765,261243,0.0641739682977152,2020-09-01,"Kansas City, MO",244478
"1618","2020","M10","October",13436,258424,0.05199207503947,2020-10-01,"Kansas City, MO",244988
"1619","2020","M11","November",13420,259571,0.0517006907551306,2020-11-01,"Kansas City, MO",246151
"1620","2020","M12","December",14157,261431,0.0541519559654364,2020-12-01,"Kansas City, MO",247274
"1621","2021","M01","January",14560,259583,0.0560899596660798,2021-01-01,"Kansas City, MO",245023
"1622","2021","M02","February",15032,260301,0.0577485295869013,2021-02-01,"Kansas City, MO",245269
"1623","2021","M03","March",13866,263738,0.0525749038818828,2021-03-01,"Kansas City, MO",249872
"1624","2021","M04","April",14216,265141,0.0536167548587355,2021-04-01,"Kansas City, MO",250925
"1625","2021","M05","May",16866,268971,0.0627056448464704,2021-05-01,"Kansas City, MO",252105
"1626","2021","M06","June",17852,270320,0.0660402485942587,2021-06-01,"Kansas City, MO",252468
"1627","2021","M07","July",13241,271297,0.048806289785733,2021-07-01,"Kansas City, MO",258056
"1628","2021","M08","August",11642,267970,0.0434451617718401,2021-08-01,"Kansas City, MO",256328
"1629","2021","M09","September",9423,263905,0.0357060305791857,2021-09-01,"Kansas City, MO",254482
"1630","2021","M10","October",8575,263462,0.032547388238152,2021-10-01,"Kansas City, MO",254887
"1631","2021","M11","November",7624,261525,0.0291520887104483,2021-11-01,"Kansas City, MO",253901
"1632","2021","M12","December",7630,262192,0.0291008116189663,2021-12-01,"Kansas City, MO",254562
"1633","2020","M01","January",34528,393050,0.0878463299834627,2020-01-01,"Kern County, CA",358522
"1634","2020","M02","February",35563,389747,0.0912463726468709,2020-02-01,"Kern County, CA",354184
"1635","2020","M03","March",42450,386184,0.109921695357653,2020-03-01,"Kern County, CA",343734
"1636","2020","M04","April",69695,374498,0.186102462496462,2020-04-01,"Kern County, CA",304803
"1637","2020","M05","May",64636,382878,0.168816176432179,2020-05-01,"Kern County, CA",318242
"1638","2020","M06","June",59991,383066,0.156607477562613,2020-06-01,"Kern County, CA",323075
"1639","2020","M07","July",57699,379667,0.151972649716725,2020-07-01,"Kern County, CA",321968
"1640","2020","M08","August",50164,385614,0.130088637860659,2020-08-01,"Kern County, CA",335450
"1641","2020","M09","September",45541,382804,0.118966886448417,2020-09-01,"Kern County, CA",337263
"1642","2020","M10","October",41238,388703,0.106091283061875,2020-10-01,"Kern County, CA",347465
"1643","2020","M11","November",34350,379585,0.0904935653410962,2020-11-01,"Kern County, CA",345235
"1644","2020","M12","December",40890,379429,0.107767197552111,2020-12-01,"Kern County, CA",338539
"1645","2021","M01","January",41192,380003,0.108399144217283,2021-01-01,"Kern County, CA",338811
"1646","2021","M02","February",41423,379994,0.109009615941304,2021-02-01,"Kern County, CA",338571
"1647","2021","M03","March",40752,368230,0.110669961708715,2021-03-01,"Kern County, CA",327478
"1648","2021","M04","April",39740,373296,0.106457074278856,2021-04-01,"Kern County, CA",333556
"1649","2021","M05","May",37749,378502,0.0997326302106726,2021-05-01,"Kern County, CA",340753
"1650","2021","M06","June",41583,382498,0.108714293930949,2021-06-01,"Kern County, CA",340915
"1651","2021","M07","July",40566,377668,0.10741180084095,2021-07-01,"Kern County, CA",337102
"1652","2021","M08","August",38342,385876,0.0993635261068322,2021-08-01,"Kern County, CA",347534
"1653","2021","M09","September",33471,386476,0.0866056365725168,2021-09-01,"Kern County, CA",353005
"1654","2021","M10","October",32174,389765,0.0825471758623786,2021-10-01,"Kern County, CA",357591
"1655","2021","M11","November",28644,388221,0.0737827165454728,2021-11-01,"Kern County, CA",359577
"1656","2021","M12","December",28999,378206,0.0766751452911905,2021-12-01,"Kern County, CA",349207
"1657","2020","M01","January",33299,1303173,0.0255522482433261,2020-01-01,"King County, WA",1269874
"1658","2020","M02","February",32611,1317445,0.0247532155042525,2020-02-01,"King County, WA",1284834
"1659","2020","M03","March",67664,1283248,0.0527287009214119,2020-03-01,"King County, WA",1215584
"1660","2020","M04","April",188620,1252637,0.150578339934075,2020-04-01,"King County, WA",1064017
"1661","2020","M05","May",154511,1270104,0.121652242650996,2020-05-01,"King County, WA",1115593
"1662","2020","M06","June",135659,1282074,0.10581214500879,2020-06-01,"King County, WA",1146415
"1663","2020","M07","July",119931,1285777,0.0932751169137417,2020-07-01,"King County, WA",1165846
"1664","2020","M08","August",100462,1291239,0.0778027925116884,2020-08-01,"King County, WA",1190777
"1665","2020","M09","September",93557,1290702,0.0724853606796921,2020-09-01,"King County, WA",1197145
"1666","2020","M10","October",80760,1285552,0.0628212627727233,2020-10-01,"King County, WA",1204792
"1667","2020","M11","November",75918,1293751,0.0586805343532102,2020-11-01,"King County, WA",1217833
"1668","2020","M12","December",74283,1283590,0.0578712828862799,2020-12-01,"King County, WA",1209307
"1669","2021","M01","January",82170,1298850,0.0632636563113523,2021-01-01,"King County, WA",1216680
"1670","2021","M02","February",70654,1315493,0.0537091417438177,2021-02-01,"King County, WA",1244839
"1671","2021","M03","March",72537,1310433,0.0553534595053696,2021-03-01,"King County, WA",1237896
"1672","2021","M04","April",64226,1304727,0.049225623444598,2021-04-01,"King County, WA",1240501
"1673","2021","M05","May",59857,1293755,0.0462661013870478,2021-05-01,"King County, WA",1233898
"1674","2021","M06","June",66269,1297414,0.0510777592965699,2021-06-01,"King County, WA",1231145
"1675","2021","M07","July",66626,1316199,0.0506200050296346,2021-07-01,"King County, WA",1249573
"1676","2021","M08","August",62708,1317920,0.0475810367852373,2021-08-01,"King County, WA",1255212
"1677","2021","M09","September",57761,1309988,0.0440927703154533,2021-09-01,"King County, WA",1252227
"1678","2021","M10","October",57252,1298675,0.0440849327198876,2021-10-01,"King County, WA",1241423
"1679","2021","M11","November",38111,1288365,0.0295809029273537,2021-11-01,"King County, WA",1250254
"1680","2021","M12","December",41443,1314451,0.0315287523079978,2021-12-01,"King County, WA",1273008
"1681","2020","M01","January",7802,245228,0.0318152902604923,2020-01-01,"Knox County, TN",237426
"1682","2020","M02","February",7751,246710,0.0314174536905679,2020-02-01,"Knox County, TN",238959
"1683","2020","M03","March",8749,245121,0.0356925763194504,2020-03-01,"Knox County, TN",236372
"1684","2020","M04","April",30675,232708,0.13181755676642,2020-04-01,"Knox County, TN",202033
"1685","2020","M05","May",17450,232887,0.0749290428405192,2020-05-01,"Knox County, TN",215437
"1686","2020","M06","June",18032,234704,0.0768286863453541,2020-06-01,"Knox County, TN",216672
"1687","2020","M07","July",16902,234497,0.0720776811643646,2020-07-01,"Knox County, TN",217595
"1688","2020","M08","August",14511,247495,0.0586314875047981,2020-08-01,"Knox County, TN",232984
"1689","2020","M09","September",13950,248327,0.0561759293190028,2020-09-01,"Knox County, TN",234377
"1690","2020","M10","October",14642,251196,0.058289144731604,2020-10-01,"Knox County, TN",236554
"1691","2020","M11","November",10311,246241,0.0418736116243842,2020-11-01,"Knox County, TN",235930
"1692","2020","M12","December",11551,246590,0.0468429376698163,2020-12-01,"Knox County, TN",235039
"1693","2021","M01","January",10351,245620,0.0421423336861819,2021-01-01,"Knox County, TN",235269
"1694","2021","M02","February",9406,245214,0.0383583319060086,2021-02-01,"Knox County, TN",235808
"1695","2021","M03","March",10072,245082,0.0410964493516456,2021-03-01,"Knox County, TN",235010
"1696","2021","M04","April",8630,245952,0.0350881472807702,2021-04-01,"Knox County, TN",237322
"1697","2021","M05","May",8785,245498,0.0357844055756055,2021-05-01,"Knox County, TN",236713
"1698","2021","M06","June",11139,248651,0.0447977285432192,2021-06-01,"Knox County, TN",237512
"1699","2021","M07","July",8951,250123,0.0357863930945975,2021-07-01,"Knox County, TN",241172
"1700","2021","M08","August",8146,245993,0.0331147634282276,2021-08-01,"Knox County, TN",237847
"1701","2021","M09","September",6561,244176,0.0268699626498919,2021-09-01,"Knox County, TN",237615
"1702","2021","M10","October",6485,245344,0.0264322746837094,2021-10-01,"Knox County, TN",238859
"1703","2021","M11","November",6036,247844,0.0243540291473669,2021-11-01,"Knox County, TN",241808
"1704","2021","M12","December",6547,249357,0.0262555292211568,2021-12-01,"Knox County, TN",242810
"1705","2020","M01","January",15445,372170,0.0414998522180724,2020-01-01,"Lake County, IL",356725
"1706","2020","M02","February",14081,370309,0.038025000742623,2020-02-01,"Lake County, IL",356228
"1707","2020","M03","March",15424,364881,0.0422713158536619,2020-03-01,"Lake County, IL",349457
"1708","2020","M04","April",50721,339315,0.149480571150701,2020-04-01,"Lake County, IL",288594
"1709","2020","M05","May",47748,349952,0.136441569129481,2020-05-01,"Lake County, IL",302204
"1710","2020","M06","June",44453,371596,0.119627229571901,2020-06-01,"Lake County, IL",327143
"1711","2020","M07","July",38968,364755,0.10683335389508,2020-07-01,"Lake County, IL",325787
"1712","2020","M08","August",31053,374322,0.0829579880423806,2020-08-01,"Lake County, IL",343269
"1713","2020","M09","September",26188,370344,0.0707126347395935,2020-09-01,"Lake County, IL",344156
"1714","2020","M10","October",22460,380222,0.0590707534019599,2020-10-01,"Lake County, IL",357762
"1715","2020","M11","November",21237,359694,0.0590418522410716,2020-11-01,"Lake County, IL",338457
"1716","2020","M12","December",25152,356962,0.0704612815929987,2020-12-01,"Lake County, IL",331810
"1717","2021","M01","January",27094,356816,0.0759326936011838,2021-01-01,"Lake County, IL",329722
"1718","2021","M02","February",22270,351359,0.0633824663663091,2021-02-01,"Lake County, IL",329089
"1719","2021","M03","March",22604,350397,0.0645096847290359,2021-03-01,"Lake County, IL",327793
"1720","2021","M04","April",20041,351801,0.0569668647900375,2021-04-01,"Lake County, IL",331760
"1721","2021","M05","May",16418,352358,0.0465946565708739,2021-05-01,"Lake County, IL",335940
"1722","2021","M06","June",19996,363820,0.0549612445714914,2021-06-01,"Lake County, IL",343824
"1723","2021","M07","July",18209,371196,0.0490549467127879,2021-07-01,"Lake County, IL",352987
"1724","2021","M08","August",19774,363821,0.0543509033288348,2021-08-01,"Lake County, IL",344047
"1725","2021","M09","September",14310,361205,0.039617391785828,2021-09-01,"Lake County, IL",346895
"1726","2021","M10","October",14355,357526,0.0401509260864944,2021-10-01,"Lake County, IL",343171
"1727","2021","M11","November",14167,365578,0.0387523319236934,2021-11-01,"Lake County, IL",351411
"1728","2021","M12","December",14448,358329,0.0403204875965942,2021-12-01,"Lake County, IL",343881
"1729","2020","M01","January",4982,177635,0.0280462746643398,2020-01-01,"Lancaster County, NE",172653
"1730","2020","M02","February",4825,179779,0.0268385072783807,2020-02-01,"Lancaster County, NE",174954
"1731","2020","M03","March",5590,178420,0.031330568321937,2020-03-01,"Lancaster County, NE",172830
"1732","2020","M04","April",14399,177981,0.0809018940223956,2020-04-01,"Lancaster County, NE",163582
"1733","2020","M05","May",9597,176587,0.0543471489973781,2020-05-01,"Lancaster County, NE",166990
"1734","2020","M06","June",12106,178469,0.0678325087270058,2020-06-01,"Lancaster County, NE",166363
"1735","2020","M07","July",8713,177674,0.0490392516631584,2020-07-01,"Lancaster County, NE",168961
"1736","2020","M08","August",6923,177086,0.0390939995256542,2020-08-01,"Lancaster County, NE",170163
"1737","2020","M09","September",6468,176034,0.0367429019393981,2020-09-01,"Lancaster County, NE",169566
"1738","2020","M10","October",5633,176468,0.0319208015050887,2020-10-01,"Lancaster County, NE",170835
"1739","2020","M11","November",5271,174968,0.0301255086644415,2020-11-01,"Lancaster County, NE",169697
"1740","2020","M12","December",5484,172973,0.0317043700461922,2020-12-01,"Lancaster County, NE",167489
"1741","2021","M01","January",5621,171482,0.0327789505604087,2021-01-01,"Lancaster County, NE",165861
"1742","2021","M02","February",5626,174402,0.0322588043715095,2021-02-01,"Lancaster County, NE",168776
"1743","2021","M03","March",5062,174345,0.0290343858441596,2021-03-01,"Lancaster County, NE",169283
"1744","2021","M04","April",3739,173817,0.0215111295212781,2021-04-01,"Lancaster County, NE",170078
"1745","2021","M05","May",3835,176389,0.0217417185878938,2021-05-01,"Lancaster County, NE",172554
"1746","2021","M06","June",4460,177011,0.025196174249058,2021-06-01,"Lancaster County, NE",172551
"1747","2021","M07","July",3328,178021,0.0186944236915869,2021-07-01,"Lancaster County, NE",174693
"1748","2021","M08","August",3012,177812,0.0169392391964547,2021-08-01,"Lancaster County, NE",174800
"1749","2021","M09","September",2324,177786,0.0130718954248366,2021-09-01,"Lancaster County, NE",175462
"1750","2021","M10","October",2305,177970,0.0129516210597292,2021-10-01,"Lancaster County, NE",175665
"1751","2021","M11","November",1944,177742,0.0109372011117237,2021-11-01,"Lancaster County, NE",175798
"1752","2021","M12","December",2033,176037,0.0115487085101428,2021-12-01,"Lancaster County, NE",174004
"1753","2020","M01","January",11062,284109,0.0389357605707669,2020-01-01,"Lancaster County, PA",273047
"1754","2020","M02","February",11048,286859,0.0385136948814574,2020-02-01,"Lancaster County, PA",275811
"1755","2020","M03","March",11611,284207,0.040854025411056,2020-03-01,"Lancaster County, PA",272596
"1756","2020","M04","April",40499,272614,0.148558034436969,2020-04-01,"Lancaster County, PA",232115
"1757","2020","M05","May",34340,283430,0.121158663514801,2020-05-01,"Lancaster County, PA",249090
"1758","2020","M06","June",33218,283722,0.117079394618676,2020-06-01,"Lancaster County, PA",250504
"1759","2020","M07","July",32052,287269,0.111574865370089,2020-07-01,"Lancaster County, PA",255217
"1760","2020","M08","August",22608,280200,0.0806852248394004,2020-08-01,"Lancaster County, PA",257592
"1761","2020","M09","September",15348,281541,0.054514262576321,2020-09-01,"Lancaster County, PA",266193
"1762","2020","M10","October",13681,280900,0.0487041651833393,2020-10-01,"Lancaster County, PA",267219
"1763","2020","M11","November",13607,278771,0.0488106725591973,2020-11-01,"Lancaster County, PA",265164
"1764","2020","M12","December",14336,277207,0.0517158657609656,2020-12-01,"Lancaster County, PA",262871
"1765","2021","M01","January",17237,274689,0.0627509656375028,2021-01-01,"Lancaster County, PA",257452
"1766","2021","M02","February",17158,278356,0.0616404891577692,2021-02-01,"Lancaster County, PA",261198
"1767","2021","M03","March",15147,276139,0.0548528096357269,2021-03-01,"Lancaster County, PA",260992
"1768","2021","M04","April",13173,274560,0.0479785839160839,2021-04-01,"Lancaster County, PA",261387
"1769","2021","M05","May",12203,276485,0.0441362099209722,2021-05-01,"Lancaster County, PA",264282
"1770","2021","M06","June",14304,280024,0.0510813358854955,2021-06-01,"Lancaster County, PA",265720
"1771","2021","M07","July",15567,284115,0.0547911937067737,2021-07-01,"Lancaster County, PA",268548
"1772","2021","M08","August",14974,282126,0.0530755761610061,2021-08-01,"Lancaster County, PA",267152
"1773","2021","M09","September",11689,277924,0.0420582605316561,2021-09-01,"Lancaster County, PA",266235
"1774","2021","M10","October",10706,279047,0.0383662967170405,2021-10-01,"Lancaster County, PA",268341
"1775","2021","M11","November",9096,275926,0.0329653602777556,2021-11-01,"Lancaster County, PA",266830
"1776","2021","M12","December",8162,272699,0.029930436121878,2021-12-01,"Lancaster County, PA",264537
"1777","2020","M01","January",5545,156482,0.0354353855395509,2020-01-01,"Leon County, FL",150937
"1778","2020","M02","February",4732,156851,0.0301687588858216,2020-02-01,"Leon County, FL",152119
"1779","2020","M03","March",7894,157989,0.0499655039274886,2020-03-01,"Leon County, FL",150095
"1780","2020","M04","April",12897,143237,0.0900395847441653,2020-04-01,"Leon County, FL",130340
"1781","2020","M05","May",13202,145225,0.0909072129454295,2020-05-01,"Leon County, FL",132023
"1782","2020","M06","June",12017,145147,0.0827919281831523,2020-06-01,"Leon County, FL",133130
"1783","2020","M07","July",13762,149705,0.0919274573327544,2020-07-01,"Leon County, FL",135943
"1784","2020","M08","August",9342,149292,0.062575355678804,2020-08-01,"Leon County, FL",139950
"1785","2020","M09","September",7859,152392,0.051570948606226,2020-09-01,"Leon County, FL",144533
"1786","2020","M10","October",6698,152218,0.0440026803663167,2020-10-01,"Leon County, FL",145520
"1787","2020","M11","November",6002,150634,0.0398449221291342,2020-11-01,"Leon County, FL",144632
"1788","2020","M12","December",4966,148335,0.0334782755249941,2020-12-01,"Leon County, FL",143369
"1789","2021","M01","January",6587,152355,0.0432345508844475,2021-01-01,"Leon County, FL",145768
"1790","2021","M02","February",7112,155326,0.0457875693702278,2021-02-01,"Leon County, FL",148214
"1791","2021","M03","March",7163,155596,0.046035887812026,2021-03-01,"Leon County, FL",148433
"1792","2021","M04","April",7275,156222,0.0465683450474325,2021-04-01,"Leon County, FL",148947
"1793","2021","M05","May",7069,156054,0.0452984223409845,2021-05-01,"Leon County, FL",148985
"1794","2021","M06","June",8451,156663,0.053943815706325,2021-06-01,"Leon County, FL",148212
"1795","2021","M07","July",7890,156857,0.0503005922591915,2021-07-01,"Leon County, FL",148967
"1796","2021","M08","August",7313,156213,0.0468142856228355,2021-08-01,"Leon County, FL",148900
"1797","2021","M09","September",6295,157947,0.0398551412815691,2021-09-01,"Leon County, FL",151652
"1798","2021","M10","October",6456,159146,0.040566523820894,2021-10-01,"Leon County, FL",152690
"1799","2021","M11","November",5563,157850,0.0352423186569528,2021-11-01,"Leon County, FL",152287
"1800","2021","M12","December",5390,156765,0.034382674704175,2021-12-01,"Leon County, FL",151375
"1801","2020","M01","January",5857,175841,0.0333085002928782,2020-01-01,"Lexington-Fayette, KY",169984
"1802","2020","M02","February",5454,176039,0.0309817710848164,2020-02-01,"Lexington-Fayette, KY",170585
"1803","2020","M03","March",6450,175717,0.0367067500583324,2020-03-01,"Lexington-Fayette, KY",169267
"1804","2020","M04","April",25628,173688,0.147551932200267,2020-04-01,"Lexington-Fayette, KY",148060
"1805","2020","M05","May",16831,175901,0.0956845043518798,2020-05-01,"Lexington-Fayette, KY",159070
"1806","2020","M06","June",9065,170262,0.0532414749033842,2020-06-01,"Lexington-Fayette, KY",161197
"1807","2020","M07","July",9411,169434,0.0555437515492758,2020-07-01,"Lexington-Fayette, KY",160023
"1808","2020","M08","August",8158,169554,0.048114465008198,2020-08-01,"Lexington-Fayette, KY",161396
"1809","2020","M09","September",8083,168346,0.0480142088318107,2020-09-01,"Lexington-Fayette, KY",160263
"1810","2020","M10","October",7623,170371,0.0447435302956489,2020-10-01,"Lexington-Fayette, KY",162748
"1811","2020","M11","November",7797,172169,0.0452868983382607,2020-11-01,"Lexington-Fayette, KY",164372
"1812","2020","M12","December",8193,170085,0.0481700326307435,2020-12-01,"Lexington-Fayette, KY",161892
"1813","2021","M01","January",7409,167438,0.0442492146346707,2021-01-01,"Lexington-Fayette, KY",160029
"1814","2021","M02","February",7340,168419,0.0435817811529578,2021-02-01,"Lexington-Fayette, KY",161079
"1815","2021","M03","March",7375,169153,0.0435995814440181,2021-03-01,"Lexington-Fayette, KY",161778
"1816","2021","M04","April",5512,169907,0.0324412766984291,2021-04-01,"Lexington-Fayette, KY",164395
"1817","2021","M05","May",5701,169856,0.0335637245666918,2021-05-01,"Lexington-Fayette, KY",164155
"1818","2021","M06","June",7708,169348,0.0455157427309446,2021-06-01,"Lexington-Fayette, KY",161640
"1819","2021","M07","July",6649,169902,0.039134324492943,2021-07-01,"Lexington-Fayette, KY",163253
"1820","2021","M08","August",5464,170180,0.0321071806322717,2021-08-01,"Lexington-Fayette, KY",164716
"1821","2021","M09","September",5535,169003,0.0327508979130548,2021-09-01,"Lexington-Fayette, KY",163468
"1822","2021","M10","October",5356,170279,0.031454260360937,2021-10-01,"Lexington-Fayette, KY",164923
"1823","2021","M11","November",4068,172100,0.0236374201045904,2021-11-01,"Lexington-Fayette, KY",168032
"1824","2021","M12","December",4518,172085,0.0262544672690821,2021-12-01,"Lexington-Fayette, KY",167567
"1825","2020","M01","January",12073,243054,0.0496720893299431,2020-01-01,"Long Beach, CA",230981
"1826","2020","M02","February",11692,243394,0.0480373386361209,2020-02-01,"Long Beach, CA",231702
"1827","2020","M03","March",12956,230326,0.0562507055217388,2020-03-01,"Long Beach, CA",217370
"1828","2020","M04","April",40781,222150,0.183574161602521,2020-04-01,"Long Beach, CA",181369
"1829","2020","M05","May",41516,218002,0.190438619829176,2020-05-01,"Long Beach, CA",176486
"1830","2020","M06","June",40579,225763,0.179741587416893,2020-06-01,"Long Beach, CA",185184
"1831","2020","M07","July",42745,230762,0.185234137336303,2020-07-01,"Long Beach, CA",188017
"1832","2020","M08","August",41725,231671,0.180104544807076,2020-08-01,"Long Beach, CA",189946
"1833","2020","M09","September",31011,225463,0.137543632436364,2020-09-01,"Long Beach, CA",194452
"1834","2020","M10","October",30409,233301,0.130342347439574,2020-10-01,"Long Beach, CA",202892
"1835","2020","M11","November",30569,232909,0.131248685108776,2020-11-01,"Long Beach, CA",202340
"1836","2020","M12","December",32234,231231,0.139401723817308,2020-12-01,"Long Beach, CA",198997
"1837","2021","M01","January",33157,233054,0.142271748178534,2021-01-01,"Long Beach, CA",199897
"1838","2021","M02","February",28233,241120,0.117091074983411,2021-02-01,"Long Beach, CA",212887
"1839","2021","M03","March",27849,239761,0.116153169197659,2021-03-01,"Long Beach, CA",211912
"1840","2021","M04","April",27886,239826,0.116275966742555,2021-04-01,"Long Beach, CA",211940
"1841","2021","M05","May",25427,239816,0.106027120792608,2021-05-01,"Long Beach, CA",214389
"1842","2021","M06","June",25062,236939,0.105774059990124,2021-06-01,"Long Beach, CA",211877
"1843","2021","M07","July",25466,238857,0.10661609247374,2021-07-01,"Long Beach, CA",213391
"1844","2021","M08","August",24035,235493,0.102062481687354,2021-08-01,"Long Beach, CA",211458
"1845","2021","M09","September",20609,236150,0.0872708024560661,2021-09-01,"Long Beach, CA",215541
"1846","2021","M10","October",20017,235982,0.0848242662575959,2021-10-01,"Long Beach, CA",215965
"1847","2021","M11","November",18126,238101,0.0761273577179432,2021-11-01,"Long Beach, CA",219975
"1848","2021","M12","December",15690,234946,0.0667813029376963,2021-12-01,"Long Beach, CA",219256
"1849","2020","M01","January",103296,2125042,0.0486089216119023,2020-01-01,"Los Angeles, CA",2021746
"1850","2020","M02","February",100477,2128528,0.0472049228386942,2020-02-01,"Los Angeles, CA",2028051
"1851","2020","M03","March",113122,2015730,0.0561196191950311,2020-03-01,"Los Angeles, CA",1902608
"1852","2020","M04","April",361744,1949242,0.185581882598466,2020-04-01,"Los Angeles, CA",1587498
"1853","2020","M05","May",364000,1908753,0.19070042064112,2020-05-01,"Los Angeles, CA",1544753
"1854","2020","M06","June",360358,1981245,0.181884623052676,2020-06-01,"Los Angeles, CA",1620887
"1855","2020","M07","July",373723,2019410,0.185065439905715,2020-07-01,"Los Angeles, CA",1645687
"1856","2020","M08","August",357110,2019675,0.176815576763588,2020-08-01,"Los Angeles, CA",1662565
"1857","2020","M09","September",260398,1962406,0.132693234733281,2020-09-01,"Los Angeles, CA",1702008
"1858","2020","M10","October",238963,2014845,0.118601182721252,2020-10-01,"Los Angeles, CA",1775882
"1859","2020","M11","November",238187,2009241,0.118545759319066,2020-11-01,"Los Angeles, CA",1771054
"1860","2020","M12","December",240594,1982385,0.121365930432282,2020-12-01,"Los Angeles, CA",1741791
"1861","2021","M01","January",251327,2000993,0.125601139034469,2021-01-01,"Los Angeles, CA",1749666
"1862","2021","M02","February",221882,2085250,0.106405466970387,2021-02-01,"Los Angeles, CA",1863368
"1863","2021","M03","March",224380,2079218,0.107915572104512,2021-03-01,"Los Angeles, CA",1854838
"1864","2021","M04","April",232734,2087818,0.111472360138671,2021-04-01,"Los Angeles, CA",1855084
"1865","2021","M05","May",213618,2090131,0.102203163342393,2021-05-01,"Los Angeles, CA",1876513
"1866","2021","M06","June",213342,2067870,0.103169928477129,2021-06-01,"Los Angeles, CA",1854528
"1867","2021","M07","July",212717,2080496,0.102243407341326,2021-07-01,"Los Angeles, CA",1867779
"1868","2021","M08","August",199307,2050169,0.0972149125267234,2021-08-01,"Los Angeles, CA",1850862
"1869","2021","M09","September",168669,2055271,0.0820665498613078,2021-09-01,"Los Angeles, CA",1886602
"1870","2021","M10","October",162938,2053248,0.0793562199987532,2021-10-01,"Los Angeles, CA",1890310
"1871","2021","M11","November",148674,2074079,0.071681936898257,2021-11-01,"Los Angeles, CA",1925405
"1872","2021","M12","December",130346,2049462,0.0636001057838594,2021-12-01,"Los Angeles, CA",1919116
"1873","2020","M01","January",5069,229710,0.0220669539854599,2020-01-01,"Loudoun County, VA",224641
"1874","2020","M02","February",4505,230822,0.0195172037327464,2020-02-01,"Loudoun County, VA",226317
"1875","2020","M03","March",5070,229850,0.0220578638242332,2020-03-01,"Loudoun County, VA",224780
"1876","2020","M04","April",22112,224143,0.0986513074242782,2020-04-01,"Loudoun County, VA",202031
"1877","2020","M05","May",16877,219065,0.0770410608723438,2020-05-01,"Loudoun County, VA",202188
"1878","2020","M06","June",17822,223852,0.0796151028358022,2020-06-01,"Loudoun County, VA",206030
"1879","2020","M07","July",15460,222956,0.06934103589946,2020-07-01,"Loudoun County, VA",207496
"1880","2020","M08","August",13491,225265,0.0598894635207422,2020-08-01,"Loudoun County, VA",211774
"1881","2020","M09","September",11884,219658,0.0541022862814011,2020-09-01,"Loudoun County, VA",207774
"1882","2020","M10","October",10482,218649,0.0479398487987597,2020-10-01,"Loudoun County, VA",208167
"1883","2020","M11","November",10093,217712,0.0463594105974866,2020-11-01,"Loudoun County, VA",207619
"1884","2020","M12","December",10368,216648,0.0478564307078764,2020-12-01,"Loudoun County, VA",206280
"1885","2021","M01","January",9934,215898,0.0460124688510315,2021-01-01,"Loudoun County, VA",205964
"1886","2021","M02","February",9302,216341,0.0429969353936609,2021-02-01,"Loudoun County, VA",207039
"1887","2021","M03","March",8983,217806,0.0412431246154835,2021-03-01,"Loudoun County, VA",208823
"1888","2021","M04","April",6666,216720,0.0307585825027685,2021-04-01,"Loudoun County, VA",210054
"1889","2021","M05","May",7125,218315,0.0326363282413027,2021-05-01,"Loudoun County, VA",211190
"1890","2021","M06","June",7943,220993,0.0359423149149521,2021-06-01,"Loudoun County, VA",213050
"1891","2021","M07","July",7129,221856,0.0321334559353815,2021-07-01,"Loudoun County, VA",214727
"1892","2021","M08","August",6617,220388,0.0300243207434162,2021-08-01,"Loudoun County, VA",213771
"1893","2021","M09","September",5418,218396,0.0248081466693529,2021-09-01,"Loudoun County, VA",212978
"1894","2021","M10","October",4899,220933,0.0221741432923103,2021-10-01,"Loudoun County, VA",216034
"1895","2021","M11","November",4575,220795,0.0207205779116375,2021-11-01,"Loudoun County, VA",216220
"1896","2021","M12","December",4747,220150,0.0215625709743357,2021-12-01,"Loudoun County, VA",215403
"1897","2020","M01","January",15704,398107,0.0394466814198193,2020-01-01,"Louisville Jefferson County Metro Government, KY",382403
"1898","2020","M02","February",14852,400035,0.0371267514092517,2020-02-01,"Louisville Jefferson County Metro Government, KY",385183
"1899","2020","M03","March",17276,399256,0.0432704830985633,2020-03-01,"Louisville Jefferson County Metro Government, KY",381980
"1900","2020","M04","April",68167,401620,0.169730093122852,2020-04-01,"Louisville Jefferson County Metro Government, KY",333453
"1901","2020","M05","May",48359,401662,0.120397249428624,2020-05-01,"Louisville Jefferson County Metro Government, KY",353303
"1902","2020","M06","June",24806,383759,0.0646395263694141,2020-06-01,"Louisville Jefferson County Metro Government, KY",358953
"1903","2020","M07","July",24996,383281,0.0652158599043522,2020-07-01,"Louisville Jefferson County Metro Government, KY",358285
"1904","2020","M08","August",21619,384411,0.0562392855563446,2020-08-01,"Louisville Jefferson County Metro Government, KY",362792
"1905","2020","M09","September",21800,383112,0.0569024201799996,2020-09-01,"Louisville Jefferson County Metro Government, KY",361312
"1906","2020","M10","October",20499,381044,0.0537969368366908,2020-10-01,"Louisville Jefferson County Metro Government, KY",360545
"1907","2020","M11","November",21207,385762,0.0549743105852832,2020-11-01,"Louisville Jefferson County Metro Government, KY",364555
"1908","2020","M12","December",21316,383791,0.0555406458202511,2020-12-01,"Louisville Jefferson County Metro Government, KY",362475
"1909","2021","M01","January",21691,381756,0.0568190152872515,2021-01-01,"Louisville Jefferson County Metro Government, KY",360065
"1910","2021","M02","February",19319,382897,0.0504548220539727,2021-02-01,"Louisville Jefferson County Metro Government, KY",363578
"1911","2021","M03","March",19280,385107,0.0500640081847383,2021-03-01,"Louisville Jefferson County Metro Government, KY",365827
"1912","2021","M04","April",16139,387274,0.0416733372237744,2021-04-01,"Louisville Jefferson County Metro Government, KY",371135
"1913","2021","M05","May",14759,386920,0.0381448361418381,2021-05-01,"Louisville Jefferson County Metro Government, KY",372161
"1914","2021","M06","June",22581,390254,0.0578623153125913,2021-06-01,"Louisville Jefferson County Metro Government, KY",367673
"1915","2021","M07","July",18790,389325,0.0482630193283247,2021-07-01,"Louisville Jefferson County Metro Government, KY",370535
"1916","2021","M08","August",13929,387907,0.0359080913724166,2021-08-01,"Louisville Jefferson County Metro Government, KY",373978
"1917","2021","M09","September",14294,386587,0.0369748594753574,2021-09-01,"Louisville Jefferson County Metro Government, KY",372293
"1918","2021","M10","October",13930,387893,0.0359119654131423,2021-10-01,"Louisville Jefferson County Metro Government, KY",373963
"1919","2021","M11","November",13245,393941,0.0336217860034878,2021-11-01,"Louisville Jefferson County Metro Government, KY",380696
"1920","2021","M12","December",13552,393917,0.034403186458061,2021-12-01,"Louisville Jefferson County Metro Government, KY",380365
"1921","2020","M01","January",3829,133374,0.0287087438331309,2020-01-01,"Lubbock, TX",129545
"1922","2020","M02","February",3660,134426,0.0272268757532025,2020-02-01,"Lubbock, TX",130766
"1923","2020","M03","March",5011,131056,0.0382355634232694,2020-03-01,"Lubbock, TX",126045
"1924","2020","M04","April",12428,123743,0.100433963941395,2020-04-01,"Lubbock, TX",111315
"1925","2020","M05","May",11275,126506,0.0891262074526109,2020-05-01,"Lubbock, TX",115231
"1926","2020","M06","June",10663,132939,0.0802097202476324,2020-06-01,"Lubbock, TX",122276
"1927","2020","M07","July",10125,133060,0.0760934916578987,2020-07-01,"Lubbock, TX",122935
"1928","2020","M08","August",7043,134807,0.0522450614582329,2020-08-01,"Lubbock, TX",127764
"1929","2020","M09","September",7906,132988,0.0594489728396547,2020-09-01,"Lubbock, TX",125082
"1930","2020","M10","October",7105,135529,0.0524242044138155,2020-10-01,"Lubbock, TX",128424
"1931","2020","M11","November",7166,133926,0.0535071606708182,2020-11-01,"Lubbock, TX",126760
"1932","2020","M12","December",6983,134333,0.0519827592624299,2020-12-01,"Lubbock, TX",127350
"1933","2021","M01","January",7757,133477,0.0581148812154903,2021-01-01,"Lubbock, TX",125720
"1934","2021","M02","February",7988,133823,0.059690785589921,2021-02-01,"Lubbock, TX",125835
"1935","2021","M03","March",7856,133763,0.0587307401897386,2021-03-01,"Lubbock, TX",125907
"1936","2021","M04","April",6796,133674,0.0508401035354669,2021-04-01,"Lubbock, TX",126878
"1937","2021","M05","May",6301,133617,0.0471571731141995,2021-05-01,"Lubbock, TX",127316
"1938","2021","M06","June",7654,133973,0.0571309144379838,2021-06-01,"Lubbock, TX",126319
"1939","2021","M07","July",6738,134661,0.050036758972531,2021-07-01,"Lubbock, TX",127923
"1940","2021","M08","August",5838,135073,0.0432210730493881,2021-08-01,"Lubbock, TX",129235
"1941","2021","M09","September",5398,135976,0.0396981820321233,2021-09-01,"Lubbock, TX",130578
"1942","2021","M10","October",5238,136034,0.0385050796124498,2021-10-01,"Lubbock, TX",130796
"1943","2021","M11","November",4858,136725,0.0355311757176815,2021-11-01,"Lubbock, TX",131867
"1944","2021","M12","December",4530,135956,0.0333196034011004,2021-12-01,"Lubbock, TX",131426
"1945","2020","M01","January",10425,159554,0.0653383807363024,2020-01-01,"Luzerne County, PA",149129
"1946","2020","M02","February",10437,159594,0.0653971953832851,2020-02-01,"Luzerne County, PA",149157
"1947","2020","M03","March",11673,159172,0.0733357625713065,2020-03-01,"Luzerne County, PA",147499
"1948","2020","M04","April",28648,154936,0.184902153147106,2020-04-01,"Luzerne County, PA",126288
"1949","2020","M05","May",25823,158756,0.162658419209353,2020-05-01,"Luzerne County, PA",132933
"1950","2020","M06","June",24735,159766,0.154820174505214,2020-06-01,"Luzerne County, PA",135031
"1951","2020","M07","July",24342,159993,0.152144156306838,2020-07-01,"Luzerne County, PA",135651
"1952","2020","M08","August",18269,154441,0.118291127356078,2020-08-01,"Luzerne County, PA",136172
"1953","2020","M09","September",13113,154788,0.084715869447244,2020-09-01,"Luzerne County, PA",141675
"1954","2020","M10","October",11911,155116,0.0767876943706645,2020-10-01,"Luzerne County, PA",143205
"1955","2020","M11","November",12346,156084,0.0790984341764691,2020-11-01,"Luzerne County, PA",143738
"1956","2020","M12","December",13371,155088,0.0862155679356236,2020-12-01,"Luzerne County, PA",141717
"1957","2021","M01","January",15909,154248,0.103139100669052,2021-01-01,"Luzerne County, PA",138339
"1958","2021","M02","February",15989,155788,0.102633065447916,2021-02-01,"Luzerne County, PA",139799
"1959","2021","M03","March",14721,154781,0.0951085727576382,2021-03-01,"Luzerne County, PA",140060
"1960","2021","M04","April",12481,152663,0.0817552386629373,2021-04-01,"Luzerne County, PA",140182
"1961","2021","M05","May",11077,151954,0.0728970609526567,2021-05-01,"Luzerne County, PA",140877
"1962","2021","M06","June",12566,153652,0.0817822091479447,2021-06-01,"Luzerne County, PA",141086
"1963","2021","M07","July",13133,155121,0.0846629405431889,2021-07-01,"Luzerne County, PA",141988
"1964","2021","M08","August",12723,153851,0.082696895047806,2021-08-01,"Luzerne County, PA",141128
"1965","2021","M09","September",10694,152477,0.070135167926966,2021-09-01,"Luzerne County, PA",141783
"1966","2021","M10","October",9774,153498,0.0636750967439315,2021-10-01,"Luzerne County, PA",143724
"1967","2021","M11","November",8917,152990,0.0582848552192954,2021-11-01,"Luzerne County, PA",144073
"1968","2021","M12","December",7906,150791,0.0524301848253543,2021-12-01,"Luzerne County, PA",142885
"1969","2020","M01","January",4579,133847,0.034210703265669,2020-01-01,"Madison County, IL",129268
"1970","2020","M02","February",4100,133472,0.0307180532246464,2020-02-01,"Madison County, IL",129372
"1971","2020","M03","March",4332,131102,0.0330429741727815,2020-03-01,"Madison County, IL",126770
"1972","2020","M04","April",18512,123493,0.149903233381649,2020-04-01,"Madison County, IL",104981
"1973","2020","M05","May",17615,127452,0.138208894328845,2020-05-01,"Madison County, IL",109837
"1974","2020","M06","June",17008,135129,0.125864914267108,2020-06-01,"Madison County, IL",118121
"1975","2020","M07","July",14235,130995,0.108668269781289,2020-07-01,"Madison County, IL",116760
"1976","2020","M08","August",10882,134550,0.0808769973987365,2020-08-01,"Madison County, IL",123668
"1977","2020","M09","September",9091,132954,0.0683770326579118,2020-09-01,"Madison County, IL",123863
"1978","2020","M10","October",7457,136631,0.0545776580717407,2020-10-01,"Madison County, IL",129174
"1979","2020","M11","November",6653,129331,0.0514416497204847,2020-11-01,"Madison County, IL",122678
"1980","2020","M12","December",7722,128468,0.0601083538313043,2020-12-01,"Madison County, IL",120746
"1981","2021","M01","January",8156,129089,0.0631812160602375,2021-01-01,"Madison County, IL",120933
"1982","2021","M02","February",6760,127013,0.0532228984434664,2021-02-01,"Madison County, IL",120253
"1983","2021","M03","March",6776,126793,0.0534414360414218,2021-03-01,"Madison County, IL",120017
"1984","2021","M04","April",6531,127865,0.051077308098385,2021-04-01,"Madison County, IL",121334
"1985","2021","M05","May",5734,127927,0.0448224377965558,2021-05-01,"Madison County, IL",122193
"1986","2021","M06","June",7107,130373,0.0545128209061692,2021-06-01,"Madison County, IL",123266
"1987","2021","M07","July",7096,132663,0.0534889155227908,2021-07-01,"Madison County, IL",125567
"1988","2021","M08","August",7268,129665,0.0560521343461998,2021-08-01,"Madison County, IL",122397
"1989","2021","M09","September",4983,129617,0.0384440312613315,2021-09-01,"Madison County, IL",124634
"1990","2021","M10","October",4875,128092,0.0380585828935453,2021-10-01,"Madison County, IL",123217
"1991","2021","M11","November",4688,130420,0.0359454071461432,2021-11-01,"Madison County, IL",125732
"1992","2021","M12","December",4274,127859,0.0334274474225514,2021-12-01,"Madison County, IL",123585
"1993","2020","M01","January",3434,155392,0.022098949752883,2020-01-01,"Madison, WI",151958
"1994","2020","M02","February",3128,157420,0.0198704103671706,2020-02-01,"Madison, WI",154292
"1995","2020","M03","March",3422,155255,0.0220411580947474,2020-03-01,"Madison, WI",151833
"1996","2020","M04","April",16715,150264,0.111237555236118,2020-04-01,"Madison, WI",133549
"1997","2020","M05","May",12880,153388,0.0839700628471588,2020-05-01,"Madison, WI",140508
"1998","2020","M06","June",11418,154162,0.0740649446685954,2020-06-01,"Madison, WI",142744
"1999","2020","M07","July",9613,157218,0.0611443982241219,2020-07-01,"Madison, WI",147605
"2000","2020","M08","August",7764,156718,0.0495412141553619,2020-08-01,"Madison, WI",148954
"2001","2020","M09","September",6672,159982,0.041704691777825,2020-09-01,"Madison, WI",153310
"2002","2020","M10","October",5514,156976,0.0351263887473244,2020-10-01,"Madison, WI",151462
"2003","2020","M11","November",5100,156825,0.032520325203252,2020-11-01,"Madison, WI",151725
"2004","2020","M12","December",4669,155372,0.0300504595422599,2020-12-01,"Madison, WI",150703
"2005","2021","M01","January",4961,153615,0.0322950232724669,2021-01-01,"Madison, WI",148654
"2006","2021","M02","February",5105,155529,0.0328234605764841,2021-02-01,"Madison, WI",150424
"2007","2021","M03","March",5136,156153,0.0328908186201994,2021-03-01,"Madison, WI",151017
"2008","2021","M04","April",5047,156935,0.0321598113868799,2021-04-01,"Madison, WI",151888
"2009","2021","M05","May",4927,158425,0.0310998895376361,2021-05-01,"Madison, WI",153498
"2010","2021","M06","June",5863,161282,0.0363524757877506,2021-06-01,"Madison, WI",155419
"2011","2021","M07","July",4983,161484,0.0308575462584528,2021-07-01,"Madison, WI",156501
"2012","2021","M08","August",4954,159970,0.0309683065574795,2021-08-01,"Madison, WI",155016
"2013","2021","M09","September",3379,160715,0.0210247954453536,2021-09-01,"Madison, WI",157336
"2014","2021","M10","October",2733,160573,0.0170202960647182,2021-10-01,"Madison, WI",157840
"2015","2021","M11","November",2180,160283,0.0136009433314824,2021-11-01,"Madison, WI",158103
"2016","2021","M12","December",1901,159742,0.011900439458627,2021-12-01,"Madison, WI",157841
"2017","2020","M01","January",97646,2337504,0.0417736183553055,2020-01-01,"Maricopa County, AZ",2239858
"2018","2020","M02","February",92689,2345084,0.0395248101986965,2020-02-01,"Maricopa County, AZ",2252395
"2019","2020","M03","March",105646,2332170,0.0452994421504436,2020-03-01,"Maricopa County, AZ",2226524
"2020","2020","M04","April",310426,2297373,0.135122159092146,2020-04-01,"Maricopa County, AZ",1986947
"2021","2020","M05","May",239777,2362690,0.101484748316538,2020-05-01,"Maricopa County, AZ",2122913
"2022","2020","M06","June",239292,2327328,0.102818339314441,2020-06-01,"Maricopa County, AZ",2088036
"2023","2020","M07","July",243508,2362138,0.103087965224724,2020-07-01,"Maricopa County, AZ",2118630
"2024","2020","M08","August",153031,2300653,0.0665163325368928,2020-08-01,"Maricopa County, AZ",2147622
"2025","2020","M09","September",152518,2321013,0.0657118249660816,2020-09-01,"Maricopa County, AZ",2168495
"2026","2020","M10","October",141146,2320245,0.0608323689955156,2020-10-01,"Maricopa County, AZ",2179099
"2027","2020","M11","November",143134,2336563,0.0612583525460259,2020-11-01,"Maricopa County, AZ",2193429
"2028","2020","M12","December",149524,2336776,0.0639873055868427,2020-12-01,"Maricopa County, AZ",2187252
"2029","2021","M01","January",154168,2340388,0.0658728381789686,2021-01-01,"Maricopa County, AZ",2186220
"2030","2021","M02","February",157741,2353403,0.0670267693208516,2021-02-01,"Maricopa County, AZ",2195662
"2031","2021","M03","March",143485,2355882,0.0609050028821478,2021-03-01,"Maricopa County, AZ",2212397
"2032","2021","M04","April",142894,2366579,0.0603799830895144,2021-04-01,"Maricopa County, AZ",2223685
"2033","2021","M05","May",146752,2381484,0.0616220810217495,2021-05-01,"Maricopa County, AZ",2234732
"2034","2021","M06","June",158287,2403400,0.0658596155446451,2021-06-01,"Maricopa County, AZ",2245113
"2035","2021","M07","July",136929,2400209,0.0570487820019007,2021-07-01,"Maricopa County, AZ",2263280
"2036","2021","M08","August",112266,2383959,0.0470922528449524,2021-08-01,"Maricopa County, AZ",2271693
"2037","2021","M09","September",90979,2399934,0.0379089591630436,2021-09-01,"Maricopa County, AZ",2308955
"2038","2021","M10","October",76713,2400542,0.0319565331495971,2021-10-01,"Maricopa County, AZ",2323829
"2039","2021","M11","November",66947,2410544,0.0277725691794051,2021-11-01,"Maricopa County, AZ",2343597
"2040","2021","M12","December",58045,2403796,0.0241472238076775,2021-12-01,"Maricopa County, AZ",2345751
"2041","2020","M01","January",3425,137803,0.0248543210234901,2020-01-01,"Marin County, CA",134378
"2042","2020","M02","February",3251,137921,0.023571464824066,2020-02-01,"Marin County, CA",134670
"2043","2020","M03","March",3840,136518,0.0281281589240979,2020-03-01,"Marin County, CA",132678
"2044","2020","M04","April",14881,123478,0.120515395455061,2020-04-01,"Marin County, CA",108597
"2045","2020","M05","May",13685,124672,0.109768031314168,2020-05-01,"Marin County, CA",110987
"2046","2020","M06","June",12853,128392,0.100107483332295,2020-06-01,"Marin County, CA",115539
"2047","2020","M07","July",11738,129179,0.0908661624567461,2020-07-01,"Marin County, CA",117441
"2048","2020","M08","August",10020,128138,0.0781969439198364,2020-08-01,"Marin County, CA",118118
"2049","2020","M09","September",8980,127528,0.0704159086631955,2020-09-01,"Marin County, CA",118548
"2050","2020","M10","October",7815,130998,0.0596573993496084,2020-10-01,"Marin County, CA",123183
"2051","2020","M11","November",6320,128817,0.04906184742697,2020-11-01,"Marin County, CA",122497
"2052","2020","M12","December",7132,128206,0.0556292217212923,2020-12-01,"Marin County, CA",121074
"2053","2021","M01","January",6968,128702,0.0541405727960715,2021-01-01,"Marin County, CA",121734
"2054","2021","M02","February",6556,131056,0.0500244170430961,2021-02-01,"Marin County, CA",124500
"2055","2021","M03","March",6163,131332,0.0469268723540341,2021-03-01,"Marin County, CA",125169
"2056","2021","M04","April",5916,129700,0.0456129529683886,2021-04-01,"Marin County, CA",123784
"2057","2021","M05","May",5591,130268,0.0429192126999724,2021-05-01,"Marin County, CA",124677
"2058","2021","M06","June",6271,131671,0.0476262806540544,2021-06-01,"Marin County, CA",125400
"2059","2021","M07","July",6101,134474,0.0453693650817258,2021-07-01,"Marin County, CA",128373
"2060","2021","M08","August",5880,133826,0.0439376503818391,2021-08-01,"Marin County, CA",127946
"2061","2021","M09","September",4820,133915,0.0359929806220364,2021-09-01,"Marin County, CA",129095
"2062","2021","M10","October",4589,134801,0.0340427741633964,2021-10-01,"Marin County, CA",130212
"2063","2021","M11","November",3951,134920,0.0292840201600949,2021-11-01,"Marin County, CA",130969
"2064","2021","M12","December",3607,133675,0.0269833551524219,2021-12-01,"Marin County, CA",130068
"2065","2020","M01","January",11498,115790,0.0993004577251922,2020-01-01,"Merced County, CA",104292
"2066","2020","M02","February",11899,116772,0.101899427945055,2020-02-01,"Merced County, CA",104873
"2067","2020","M03","March",13756,118777,0.115813667629255,2020-03-01,"Merced County, CA",105021
"2068","2020","M04","April",21592,116892,0.184717517024262,2020-04-01,"Merced County, CA",95300
"2069","2020","M05","May",18016,114828,0.156895530706796,2020-05-01,"Merced County, CA",96812
"2070","2020","M06","June",16419,113767,0.144321288247031,2020-06-01,"Merced County, CA",97348
"2071","2020","M07","July",15396,110828,0.138917962969647,2020-07-01,"Merced County, CA",95432
"2072","2020","M08","August",13330,112481,0.118508903725963,2020-08-01,"Merced County, CA",99151
"2073","2020","M09","September",12106,114259,0.105952266342258,2020-09-01,"Merced County, CA",102153
"2074","2020","M10","October",11197,115767,0.0967201361355136,2020-10-01,"Merced County, CA",104570
"2075","2020","M11","November",10021,112988,0.0886908344248947,2020-11-01,"Merced County, CA",102967
"2076","2020","M12","December",12546,113692,0.110350772261901,2020-12-01,"Merced County, CA",101146
"2077","2021","M01","January",13182,113923,0.115709733767545,2021-01-01,"Merced County, CA",100741
"2078","2021","M02","February",13513,116044,0.116447209679087,2021-02-01,"Merced County, CA",102531
"2079","2021","M03","March",13136,115196,0.114031737213098,2021-03-01,"Merced County, CA",102060
"2080","2021","M04","April",12363,113867,0.108574038132207,2021-04-01,"Merced County, CA",101504
"2081","2021","M05","May",11413,116672,0.0978212424574877,2021-05-01,"Merced County, CA",105259
"2082","2021","M06","June",12573,116440,0.107978357952594,2021-06-01,"Merced County, CA",103867
"2083","2021","M07","July",12029,117210,0.102627762136336,2021-07-01,"Merced County, CA",105181
"2084","2021","M08","August",11186,117080,0.0955415100785788,2021-08-01,"Merced County, CA",105894
"2085","2021","M09","September",9664,118309,0.0816844027081625,2021-09-01,"Merced County, CA",108645
"2086","2021","M10","October",9442,117707,0.0802161298818252,2021-10-01,"Merced County, CA",108265
"2087","2021","M11","November",8806,115382,0.0763203965956562,2021-11-01,"Merced County, CA",106576
"2088","2021","M12","December",9359,114564,0.0816923291784505,2021-12-01,"Merced County, CA",105205
"2089","2020","M01","January",17105,457518,0.037386507197531,2020-01-01,"Milwaukee County, WI",440413
"2090","2020","M02","February",17368,461262,0.0376532209460133,2020-02-01,"Milwaukee County, WI",443894
"2091","2020","M03","March",18991,455680,0.0416761762640449,2020-03-01,"Milwaukee County, WI",436689
"2092","2020","M04","April",75503,457433,0.165058052217483,2020-04-01,"Milwaukee County, WI",381930
"2093","2020","M05","May",61328,462209,0.13268456477481,2020-05-01,"Milwaukee County, WI",400881
"2094","2020","M06","June",54320,468495,0.115945741149852,2020-06-01,"Milwaukee County, WI",414175
"2095","2020","M07","July",49132,473392,0.103787136242269,2020-07-01,"Milwaukee County, WI",424260
"2096","2020","M08","August",40413,471205,0.0857652189599007,2020-08-01,"Milwaukee County, WI",430792
"2097","2020","M09","September",36894,477229,0.0773087972440904,2020-09-01,"Milwaukee County, WI",440335
"2098","2020","M10","October",31017,463115,0.0669747255001458,2020-10-01,"Milwaukee County, WI",432098
"2099","2020","M11","November",27914,460330,0.0606391067277822,2020-11-01,"Milwaukee County, WI",432416
"2100","2020","M12","December",25254,453165,0.0557280460759326,2020-12-01,"Milwaukee County, WI",427911
"2101","2021","M01","January",26671,451611,0.0590574631707377,2021-01-01,"Milwaukee County, WI",424940
"2102","2021","M02","February",28491,456943,0.0623513217184638,2021-02-01,"Milwaukee County, WI",428452
"2103","2021","M03","March",28948,458286,0.0631657960312992,2021-03-01,"Milwaukee County, WI",429338
"2104","2021","M04","April",29589,461695,0.0640877635668569,2021-04-01,"Milwaukee County, WI",432106
"2105","2021","M05","May",27409,465655,0.0588611740451622,2021-05-01,"Milwaukee County, WI",438246
"2106","2021","M06","June",31970,477497,0.0669533002301585,2021-06-01,"Milwaukee County, WI",445527
"2107","2021","M07","July",30048,482008,0.0623392142868998,2021-07-01,"Milwaukee County, WI",451960
"2108","2021","M08","August",28924,475386,0.0608431884826225,2021-08-01,"Milwaukee County, WI",446462
"2109","2021","M09","September",19413,467829,0.0414959312056328,2021-09-01,"Milwaukee County, WI",448416
"2110","2021","M10","October",16134,464931,0.0347019235112307,2021-10-01,"Milwaukee County, WI",448797
"2111","2021","M11","November",12672,462301,0.0274107129337812,2021-11-01,"Milwaukee County, WI",449629
"2112","2021","M12","December",12811,460339,0.0278294908752028,2021-12-01,"Milwaukee County, WI",447528
"2113","2020","M01","January",10998,268019,0.0410344042773087,2020-01-01,"Milwaukee, WI",257021
"2114","2020","M02","February",11265,270317,0.0416732946873486,2020-02-01,"Milwaukee, WI",259052
"2115","2020","M03","March",12365,267212,0.0462741194257743,2020-03-01,"Milwaukee, WI",254847
"2116","2020","M04","April",47506,270396,0.175690468793917,2020-04-01,"Milwaukee, WI",222890
"2117","2020","M05","May",39378,273328,0.144068664754434,2020-05-01,"Milwaukee, WI",233950
"2118","2020","M06","June",35843,277551,0.12914023008384,2020-06-01,"Milwaukee, WI",241708
"2119","2020","M07","July",32735,280329,0.116773505416849,2020-07-01,"Milwaukee, WI",247594
"2120","2020","M08","August",27217,278623,0.0976839672245292,2020-08-01,"Milwaukee, WI",251406
"2121","2020","M09","September",24866,281841,0.0882270500033707,2020-09-01,"Milwaukee, WI",256975
"2122","2020","M10","October",20939,273107,0.0766695837162724,2020-10-01,"Milwaukee, WI",252168
"2123","2020","M11","November",18975,271329,0.0699335493072985,2020-11-01,"Milwaukee, WI",252354
"2124","2020","M12","December",17371,267096,0.0650365411687184,2020-12-01,"Milwaukee, WI",249725
"2125","2021","M01","January",18222,266213,0.0684489487741019,2021-01-01,"Milwaukee, WI",247991
"2126","2021","M02","February",19565,269605,0.072569128910814,2021-02-01,"Milwaukee, WI",250040
"2127","2021","M03","March",20157,270714,0.0744586537822203,2021-03-01,"Milwaukee, WI",250557
"2128","2021","M04","April",21070,273243,0.0771108500492236,2021-04-01,"Milwaukee, WI",252173
"2129","2021","M05","May",19408,275164,0.0705324824468317,2021-05-01,"Milwaukee, WI",255756
"2130","2021","M06","June",22548,282553,0.0798009576964322,2021-06-01,"Milwaukee, WI",260005
"2131","2021","M07","July",21372,285131,0.0749550206747074,2021-07-01,"Milwaukee, WI",263759
"2132","2021","M08","August",20681,281232,0.0735371508220971,2021-08-01,"Milwaukee, WI",260551
"2133","2021","M09","September",13893,275584,0.0504129412447747,2021-09-01,"Milwaukee, WI",261691
"2134","2021","M10","October",11472,273385,0.0419627997146881,2021-10-01,"Milwaukee, WI",261913
"2135","2021","M11","November",8897,271296,0.0327944385468271,2021-11-01,"Milwaukee, WI",262399
"2136","2021","M12","December",8810,269983,0.0326316842171544,2021-12-01,"Milwaukee, WI",261173
"2137","2020","M01","January",12249,331943,0.036900913711089,2020-01-01,"Monmouth County, NJ",319694
"2138","2020","M02","February",11927,333733,0.0357381499582001,2020-02-01,"Monmouth County, NJ",321806
"2139","2020","M03","March",12239,330445,0.0370379336954713,2020-03-01,"Monmouth County, NJ",318206
"2140","2020","M04","April",51425,321432,0.159987182358944,2020-04-01,"Monmouth County, NJ",270007
"2141","2020","M05","May",50382,323537,0.155722529417037,2020-05-01,"Monmouth County, NJ",273155
"2142","2020","M06","June",48630,328225,0.148160560591058,2020-06-01,"Monmouth County, NJ",279595
"2143","2020","M07","July",41031,339240,0.120949770074284,2020-07-01,"Monmouth County, NJ",298209
"2144","2020","M08","August",31924,332501,0.0960117413180712,2020-08-01,"Monmouth County, NJ",300577
"2145","2020","M09","September",21259,318640,0.0667179261862917,2020-09-01,"Monmouth County, NJ",297381
"2146","2020","M10","October",19489,320910,0.0607304228599919,2020-10-01,"Monmouth County, NJ",301421
"2147","2020","M11","November",27143,329411,0.0823985841395703,2020-11-01,"Monmouth County, NJ",302268
"2148","2020","M12","December",19870,322528,0.0616070542712571,2020-12-01,"Monmouth County, NJ",302658
"2149","2021","M01","January",22231,320553,0.0693520260300169,2021-01-01,"Monmouth County, NJ",298322
"2150","2021","M02","February",23548,322599,0.0729946466046082,2021-02-01,"Monmouth County, NJ",299051
"2151","2021","M03","March",22376,325216,0.0688035029026862,2021-03-01,"Monmouth County, NJ",302840
"2152","2021","M04","April",19874,322028,0.061715130361335,2021-04-01,"Monmouth County, NJ",302154
"2153","2021","M05","May",19704,323785,0.0608551971215467,2021-05-01,"Monmouth County, NJ",304081
"2154","2021","M06","June",22454,330177,0.0680059483246865,2021-06-01,"Monmouth County, NJ",307723
"2155","2021","M07","July",21672,330574,0.0655586948761851,2021-07-01,"Monmouth County, NJ",308902
"2156","2021","M08","August",19632,327701,0.0599082700388464,2021-08-01,"Monmouth County, NJ",308069
"2157","2021","M09","September",17377,322714,0.0538464398817529,2021-09-01,"Monmouth County, NJ",305337
"2158","2021","M10","October",15160,325543,0.0465683488817146,2021-10-01,"Monmouth County, NJ",310383
"2159","2021","M11","November",14670,325853,0.0450203005649787,2021-11-01,"Monmouth County, NJ",311183
"2160","2021","M12","December",13655,326445,0.0418294046470309,2021-12-01,"Monmouth County, NJ",312790
"2161","2020","M01","January",21170,209703,0.100952299204112,2020-01-01,"Monterey County, CA",188533
"2162","2020","M02","February",21547,212684,0.101309924582949,2020-02-01,"Monterey County, CA",191137
"2163","2020","M03","March",23969,214867,0.111552727966603,2020-03-01,"Monterey County, CA",190898
"2164","2020","M04","April",41183,215561,0.191050329141171,2020-04-01,"Monterey County, CA",174378
"2165","2020","M05","May",32078,216395,0.148238175558585,2020-05-01,"Monterey County, CA",184317
"2166","2020","M06","June",26879,221270,0.121476024766123,2020-06-01,"Monterey County, CA",194391
"2167","2020","M07","July",22780,219315,0.103868864418758,2020-07-01,"Monterey County, CA",196535
"2168","2020","M08","August",19149,217046,0.0882255374436755,2020-08-01,"Monterey County, CA",197897
"2169","2020","M09","September",17297,213344,0.0810756337183141,2020-09-01,"Monterey County, CA",196047
"2170","2020","M10","October",15855,213602,0.0742268330820872,2020-10-01,"Monterey County, CA",197747
"2171","2020","M11","November",14332,205841,0.0696265564197609,2020-11-01,"Monterey County, CA",191509
"2172","2020","M12","December",20740,202020,0.102663102663103,2020-12-01,"Monterey County, CA",181280
"2173","2021","M01","January",23319,203073,0.114830627409848,2021-01-01,"Monterey County, CA",179754
"2174","2021","M02","February",22897,206057,0.111119738713075,2021-02-01,"Monterey County, CA",183160
"2175","2021","M03","March",21634,206682,0.104672879108969,2021-03-01,"Monterey County, CA",185048
"2176","2021","M04","April",18506,215211,0.0859900283907421,2021-04-01,"Monterey County, CA",196705
"2177","2021","M05","May",16018,221106,0.0724448906859154,2021-05-01,"Monterey County, CA",205088
"2178","2021","M06","June",16662,226506,0.0735609652724431,2021-06-01,"Monterey County, CA",209844
"2179","2021","M07","July",15688,228723,0.06858951657682,2021-07-01,"Monterey County, CA",213035
"2180","2021","M08","August",14605,227096,0.0643120090182126,2021-08-01,"Monterey County, CA",212491
"2181","2021","M09","September",12524,225111,0.0556347757328607,2021-09-01,"Monterey County, CA",212587
"2182","2021","M10","October",12283,222309,0.0552519241236297,2021-10-01,"Monterey County, CA",210026
"2183","2021","M11","November",12047,217697,0.0553383831655925,2021-11-01,"Monterey County, CA",205650
"2184","2021","M12","December",14941,208446,0.0716780365178512,2021-12-01,"Monterey County, CA",193505
"2185","2020","M01","January",16494,569587,0.0289578238267376,2020-01-01,"Montgomery County, MD",553093
"2186","2020","M02","February",16158,570989,0.0282982684429998,2020-02-01,"Montgomery County, MD",554831
"2187","2020","M03","March",17591,567052,0.0310218463209723,2020-03-01,"Montgomery County, MD",549461
"2188","2020","M04","April",40927,534946,0.0765067876009915,2020-04-01,"Montgomery County, MD",494019
"2189","2020","M05","May",46684,541732,0.0861754520685505,2020-05-01,"Montgomery County, MD",495048
"2190","2020","M06","June",47378,560277,0.0845617435661289,2020-06-01,"Montgomery County, MD",512899
"2191","2020","M07","July",47385,553262,0.0856465833547216,2020-07-01,"Montgomery County, MD",505877
"2192","2020","M08","August",45444,552801,0.0822067977445772,2020-08-01,"Montgomery County, MD",507357
"2193","2020","M09","September",34637,520463,0.0665503599679516,2020-09-01,"Montgomery County, MD",485826
"2194","2020","M10","October",34771,538771,0.0645376235914702,2020-10-01,"Montgomery County, MD",504000
"2195","2020","M11","November",35577,538637,0.0660500485484659,2020-11-01,"Montgomery County, MD",503060
"2196","2020","M12","December",33777,532257,0.0634599451017084,2020-12-01,"Montgomery County, MD",498480
"2197","2021","M01","January",30901,527768,0.0585503478801291,2021-01-01,"Montgomery County, MD",496867
"2198","2021","M02","February",30644,531321,0.0576751154198686,2021-02-01,"Montgomery County, MD",500677
"2199","2021","M03","March",30807,536785,0.0573916931359855,2021-03-01,"Montgomery County, MD",505978
"2200","2021","M04","April",30640,538700,0.0568776684611101,2021-04-01,"Montgomery County, MD",508060
"2201","2021","M05","May",30743,543622,0.0565521630839076,2021-05-01,"Montgomery County, MD",512879
"2202","2021","M06","June",35158,548082,0.064147335617663,2021-06-01,"Montgomery County, MD",512924
"2203","2021","M07","July",31691,556372,0.0569600914496057,2021-07-01,"Montgomery County, MD",524681
"2204","2021","M08","August",31507,549771,0.0573093160606871,2021-08-01,"Montgomery County, MD",518264
"2205","2021","M09","September",26717,541949,0.0492979966749639,2021-09-01,"Montgomery County, MD",515232
"2206","2021","M10","October",24660,542253,0.0454769268219816,2021-10-01,"Montgomery County, MD",517593
"2207","2021","M11","November",23120,540898,0.0427437335689908,2021-11-01,"Montgomery County, MD",517778
"2208","2021","M12","December",19340,537164,0.0360039019740712,2021-12-01,"Montgomery County, MD",517824
"2209","2020","M01","January",8249,261213,0.0315795921336228,2020-01-01,"Morris County, NJ",252964
"2210","2020","M02","February",8179,262681,0.0311366257932626,2020-02-01,"Morris County, NJ",254502
"2211","2020","M03","March",8405,260185,0.0323039375828737,2020-03-01,"Morris County, NJ",251780
"2212","2020","M04","April",32992,248985,0.132505974255477,2020-04-01,"Morris County, NJ",215993
"2213","2020","M05","May",33313,249858,0.133327730150726,2020-05-01,"Morris County, NJ",216545
"2214","2020","M06","June",32689,252050,0.129692521325134,2020-06-01,"Morris County, NJ",219361
"2215","2020","M07","July",28205,258771,0.108995984866929,2020-07-01,"Morris County, NJ",230566
"2216","2020","M08","August",22102,253860,0.0870637359174348,2020-08-01,"Morris County, NJ",231758
"2217","2020","M09","September",14549,244181,0.0595828504265279,2020-09-01,"Morris County, NJ",229632
"2218","2020","M10","October",13735,245257,0.0560024790321989,2020-10-01,"Morris County, NJ",231522
"2219","2020","M11","November",19203,249654,0.0769184551419164,2020-11-01,"Morris County, NJ",230451
"2220","2020","M12","December",13938,244361,0.0570385617999599,2020-12-01,"Morris County, NJ",230423
"2221","2021","M01","January",15566,245532,0.0633970317514621,2021-01-01,"Morris County, NJ",229966
"2222","2021","M02","February",16363,247133,0.0662113113181971,2021-02-01,"Morris County, NJ",230770
"2223","2021","M03","March",15649,249291,0.0627740271409718,2021-03-01,"Morris County, NJ",233642
"2224","2021","M04","April",13710,246477,0.0556238513126985,2021-04-01,"Morris County, NJ",232767
"2225","2021","M05","May",13635,246137,0.0553959786622897,2021-05-01,"Morris County, NJ",232502
"2226","2021","M06","June",15715,250880,0.0626395089285714,2021-06-01,"Morris County, NJ",235165
"2227","2021","M07","July",14928,251890,0.0592639644289174,2021-07-01,"Morris County, NJ",236962
"2228","2021","M08","August",13528,248655,0.0544046972713197,2021-08-01,"Morris County, NJ",235127
"2229","2021","M09","September",12108,245845,0.0492505440419777,2021-09-01,"Morris County, NJ",233737
"2230","2021","M10","October",10603,249067,0.0425708745036476,2021-10-01,"Morris County, NJ",238464
"2231","2021","M11","November",10324,248542,0.0415382510803003,2021-11-01,"Morris County, NJ",238218
"2232","2021","M12","December",9379,250150,0.0374935038976614,2021-12-01,"Morris County, NJ",240771
"2233","2020","M01","January",14277,453134,0.0315072362700658,2020-01-01,"Multnomah County, OR",438857
"2234","2020","M02","February",14054,456257,0.0308028150800974,2020-02-01,"Multnomah County, OR",442203
"2235","2020","M03","March",17200,453489,0.0379281526123015,2020-03-01,"Multnomah County, OR",436289
"2236","2020","M04","April",63166,445230,0.14187273993217,2020-04-01,"Multnomah County, OR",382064
"2237","2020","M05","May",60824,460415,0.132106903554402,2020-05-01,"Multnomah County, OR",399591
"2238","2020","M06","June",58780,466454,0.126014569496671,2020-06-01,"Multnomah County, OR",407674
"2239","2020","M07","July",54403,448039,0.121424697403574,2020-07-01,"Multnomah County, OR",393636
"2240","2020","M08","August",47541,460267,0.103290046864103,2020-08-01,"Multnomah County, OR",412726
"2241","2020","M09","September",40556,458343,0.0884839519748311,2020-09-01,"Multnomah County, OR",417787
"2242","2020","M10","October",35832,461841,0.0775851429388036,2020-10-01,"Multnomah County, OR",426009
"2243","2020","M11","November",33370,463867,0.0719387238152315,2020-11-01,"Multnomah County, OR",430497
"2244","2020","M12","December",31625,461126,0.0685821228904898,2020-12-01,"Multnomah County, OR",429501
"2245","2021","M01","January",34405,459430,0.0748862721198006,2021-01-01,"Multnomah County, OR",425025
"2246","2021","M02","February",32278,461423,0.0699531666171821,2021-02-01,"Multnomah County, OR",429145
"2247","2021","M03","March",33093,465450,0.0710989365130519,2021-03-01,"Multnomah County, OR",432357
"2248","2021","M04","April",29480,464862,0.0634166698934307,2021-04-01,"Multnomah County, OR",435382
"2249","2021","M05","May",26378,465265,0.0566945719106316,2021-05-01,"Multnomah County, OR",438887
"2250","2021","M06","June",25770,465491,0.0553608984921298,2021-06-01,"Multnomah County, OR",439721
"2251","2021","M07","July",24117,470456,0.0512630299114051,2021-07-01,"Multnomah County, OR",446339
"2252","2021","M08","August",22228,469074,0.0473869794531353,2021-08-01,"Multnomah County, OR",446846
"2253","2021","M09","September",20637,468945,0.0440072929661261,2021-09-01,"Multnomah County, OR",448308
"2254","2021","M10","October",17043,469914,0.0362683384619313,2021-10-01,"Multnomah County, OR",452871
"2255","2021","M11","November",16961,472597,0.0358889286220607,2021-11-01,"Multnomah County, OR",455636
"2256","2021","M12","December",17515,472735,0.0370503559076438,2021-12-01,"Multnomah County, OR",455220
"2257","2020","M01","January",11361,404469,0.0280886792312884,2020-01-01,"Nashville-Davidson, TN",393108
"2258","2020","M02","February",11127,405265,0.0274561089657385,2020-02-01,"Nashville-Davidson, TN",394138
"2259","2020","M03","March",13265,401339,0.0330518589023245,2020-03-01,"Nashville-Davidson, TN",388074
"2260","2020","M04","April",65091,386060,0.16860332590789,2020-04-01,"Nashville-Davidson, TN",320969
"2261","2020","M05","May",43617,384838,0.113338599618541,2020-05-01,"Nashville-Davidson, TN",341221
"2262","2020","M06","June",47055,393326,0.119633586388899,2020-06-01,"Nashville-Davidson, TN",346271
"2263","2020","M07","July",45699,395498,0.115547992657359,2020-07-01,"Nashville-Davidson, TN",349799
"2264","2020","M08","August",40061,417140,0.0960373016253536,2020-08-01,"Nashville-Davidson, TN",377079
"2265","2020","M09","September",38721,417676,0.0927058293988642,2020-09-01,"Nashville-Davidson, TN",378955
"2266","2020","M10","October",30421,412745,0.0737041030176017,2020-10-01,"Nashville-Davidson, TN",382324
"2267","2020","M11","November",19833,403008,0.049212422582182,2020-11-01,"Nashville-Davidson, TN",383175
"2268","2020","M12","December",21000,403329,0.0520666750965093,2020-12-01,"Nashville-Davidson, TN",382329
"2269","2021","M01","January",19590,402073,0.0487224956662099,2021-01-01,"Nashville-Davidson, TN",382483
"2270","2021","M02","February",17556,401302,0.0437476015569322,2021-02-01,"Nashville-Davidson, TN",383746
"2271","2021","M03","March",18559,401940,0.0461735582425238,2021-03-01,"Nashville-Davidson, TN",383381
"2272","2021","M04","April",17946,406012,0.0442006640197827,2021-04-01,"Nashville-Davidson, TN",388066
"2273","2021","M05","May",17626,407601,0.0432432697662665,2021-05-01,"Nashville-Davidson, TN",389975
"2274","2021","M06","June",21020,407348,0.0516020699745672,2021-06-01,"Nashville-Davidson, TN",386328
"2275","2021","M07","July",17500,410132,0.0426691894316952,2021-07-01,"Nashville-Davidson, TN",392632
"2276","2021","M08","August",15579,405451,0.0384238785944541,2021-08-01,"Nashville-Davidson, TN",389872
"2277","2021","M09","September",12316,401578,0.0306690107525811,2021-09-01,"Nashville-Davidson, TN",389262
"2278","2021","M10","October",11800,403483,0.0292453461484127,2021-10-01,"Nashville-Davidson, TN",391683
"2279","2021","M11","November",10796,407228,0.0265109471843783,2021-11-01,"Nashville-Davidson, TN",396432
"2280","2021","M12","December",11540,412373,0.0279843733707105,2021-12-01,"Nashville-Davidson, TN",400833
"2281","2020","M01","January",24902,707528,0.0351957802376726,2020-01-01,"Nassau County, NY",682626
"2282","2020","M02","February",25340,700532,0.0361725088932411,2020-02-01,"Nassau County, NY",675192
"2283","2020","M03","March",26649,699846,0.0380783772429935,2020-03-01,"Nassau County, NY",673197
"2284","2020","M04","April",111831,652988,0.171260421324741,2020-04-01,"Nassau County, NY",541157
"2285","2020","M05","May",90109,682195,0.13208686665836,2020-05-01,"Nassau County, NY",592086
"2286","2020","M06","June",92451,710891,0.130049473125979,2020-06-01,"Nassau County, NY",618440
"2287","2020","M07","July",93964,732557,0.128268516989122,2020-07-01,"Nassau County, NY",638593
"2288","2020","M08","August",70766,721565,0.0980729386818928,2020-08-01,"Nassau County, NY",650799
"2289","2020","M09","September",47025,694804,0.067680957507441,2020-09-01,"Nassau County, NY",647779
"2290","2020","M10","October",42185,692329,0.0609320135369167,2020-10-01,"Nassau County, NY",650144
"2291","2020","M11","November",41280,697097,0.0592170099713526,2020-11-01,"Nassau County, NY",655817
"2292","2020","M12","December",40377,694968,0.0580990779431571,2020-12-01,"Nassau County, NY",654591
"2293","2021","M01","January",43202,686842,0.0628994732412986,2021-01-01,"Nassau County, NY",643640
"2294","2021","M02","February",45534,683432,0.0666255018787531,2021-02-01,"Nassau County, NY",637898
"2295","2021","M03","March",40474,688472,0.0587881569620841,2021-03-01,"Nassau County, NY",647998
"2296","2021","M04","April",35955,687141,0.0523255052456483,2021-04-01,"Nassau County, NY",651186
"2297","2021","M05","May",32094,684188,0.046908159745567,2021-05-01,"Nassau County, NY",652094
"2298","2021","M06","June",34422,695269,0.0495088951182923,2021-06-01,"Nassau County, NY",660847
"2299","2021","M07","July",35721,699062,0.0510984719524162,2021-07-01,"Nassau County, NY",663341
"2300","2021","M08","August",34444,693002,0.0497025982608997,2021-08-01,"Nassau County, NY",658558
"2301","2021","M09","September",28353,682305,0.0415547299228351,2021-09-01,"Nassau County, NY",653952
"2302","2021","M10","October",26697,682100,0.0391394223720862,2021-10-01,"Nassau County, NY",655403
"2303","2021","M11","November",23596,679609,0.0347199639792881,2021-11-01,"Nassau County, NY",656013
"2304","2021","M12","December",17425,677698,0.0257120428273361,2021-12-01,"Nassau County, NY",660273
"2305","2020","M01","January",167171,4322755,0.0386723281795984,2020-01-01,"New York, NY",4155584
"2306","2020","M02","February",167790,4362866,0.0384586645567386,2020-02-01,"New York, NY",4195076
"2307","2020","M03","March",194509,4323640,0.0449873254942595,2020-03-01,"New York, NY",4129131
"2308","2020","M04","April",545534,3930009,0.138812404755307,2020-04-01,"New York, NY",3384475
"2309","2020","M05","May",832439,3955361,0.210458413277574,2020-05-01,"New York, NY",3122922
"2310","2020","M06","June",709116,4110222,0.172524987701394,2020-06-01,"New York, NY",3401106
"2311","2020","M07","July",720786,4129943,0.174526863930083,2020-07-01,"New York, NY",3409157
"2312","2020","M08","August",625353,4089286,0.152924740407005,2020-08-01,"New York, NY",3463933
"2313","2020","M09","September",594047,4032927,0.147299219648657,2020-09-01,"New York, NY",3438880
"2314","2020","M10","October",541512,4038187,0.134097801810565,2020-10-01,"New York, NY",3496675
"2315","2020","M11","November",515843,3996666,0.129068328451765,2020-11-01,"New York, NY",3480823
"2316","2020","M12","December",492652,3964116,0.124277897014114,2020-12-01,"New York, NY",3471464
"2317","2021","M01","January",525323,3955248,0.132816703276255,2021-01-01,"New York, NY",3429925
"2318","2021","M02","February",509331,3973098,0.128194924967871,2021-02-01,"New York, NY",3463767
"2319","2021","M03","March",469141,4161200,0.112741757185427,2021-03-01,"New York, NY",3692059
"2320","2021","M04","April",451798,4131468,0.109355318739005,2021-04-01,"New York, NY",3679670
"2321","2021","M05","May",412734,4063769,0.101564335964963,2021-05-01,"New York, NY",3651035
"2322","2021","M06","June",433870,4098425,0.105862617956898,2021-06-01,"New York, NY",3664555
"2323","2021","M07","July",411559,4094350,0.10051876366212,2021-07-01,"New York, NY",3682791
"2324","2021","M08","August",385347,4065240,0.0947907134634118,2021-08-01,"New York, NY",3679893
"2325","2021","M09","September",329543,4010979,0.0821602406793952,2021-09-01,"New York, NY",3681436
"2326","2021","M10","October",307714,4014294,0.0766545748766782,2021-10-01,"New York, NY",3706580
"2327","2021","M11","November",279469,3984173,0.0701447954192752,2021-11-01,"New York, NY",3704704
"2328","2021","M12","December",264533,3971798,0.0666028332760125,2021-12-01,"New York, NY",3707265
"2329","2020","M01","January",8103,162817,0.0497675304175854,2020-01-01,"Northampton County, PA",154714
"2330","2020","M02","February",8084,162823,0.0496490053616504,2020-02-01,"Northampton County, PA",154739
"2331","2020","M03","March",8929,161298,0.0553571649989461,2020-03-01,"Northampton County, PA",152369
"2332","2020","M04","April",25255,154240,0.163738329875519,2020-04-01,"Northampton County, PA",128985
"2333","2020","M05","May",22117,158921,0.139169776178101,2020-05-01,"Northampton County, PA",136804
"2334","2020","M06","June",22265,160375,0.138830865159782,2020-06-01,"Northampton County, PA",138110
"2335","2020","M07","July",21582,161294,0.133805349238037,2020-07-01,"Northampton County, PA",139712
"2336","2020","M08","August",15569,155472,0.100140218174334,2020-08-01,"Northampton County, PA",139903
"2337","2020","M09","September",10447,156923,0.0665740522421825,2020-09-01,"Northampton County, PA",146476
"2338","2020","M10","October",9392,156821,0.0598899382098061,2020-10-01,"Northampton County, PA",147429
"2339","2020","M11","November",9437,158347,0.0595969611044099,2020-11-01,"Northampton County, PA",148910
"2340","2020","M12","December",9682,157798,0.0613569246758514,2020-12-01,"Northampton County, PA",148116
"2341","2021","M01","January",11311,156619,0.0722198456126013,2021-01-01,"Northampton County, PA",145308
"2342","2021","M02","February",11643,157796,0.0737851403077391,2021-02-01,"Northampton County, PA",146153
"2343","2021","M03","March",10531,157207,0.0669881112164217,2021-03-01,"Northampton County, PA",146676
"2344","2021","M04","April",9118,155464,0.0586502341378068,2021-04-01,"Northampton County, PA",146346
"2345","2021","M05","May",8454,156660,0.0539639984680199,2021-05-01,"Northampton County, PA",148206
"2346","2021","M06","June",9670,158989,0.0608218178616131,2021-06-01,"Northampton County, PA",149319
"2347","2021","M07","July",10138,158571,0.0639335061265931,2021-07-01,"Northampton County, PA",148433
"2348","2021","M08","August",9935,157395,0.063121446043394,2021-08-01,"Northampton County, PA",147460
"2349","2021","M09","September",8051,156903,0.0513119570690172,2021-09-01,"Northampton County, PA",148852
"2350","2021","M10","October",7468,158716,0.0470525970916606,2021-10-01,"Northampton County, PA",151248
"2351","2021","M11","November",6520,157992,0.0412679122993569,2021-11-01,"Northampton County, PA",151472
"2352","2021","M12","December",5763,156067,0.0369264482561977,2021-12-01,"Northampton County, PA",150304
"2353","2020","M01","January",22995,673705,0.0341321498281889,2020-01-01,"Oakland County, MI",650710
"2354","2020","M02","February",20955,673128,0.0311307804756302,2020-02-01,"Oakland County, MI",652173
"2355","2020","M03","March",25772,671363,0.0383875787018349,2020-03-01,"Oakland County, MI",645591
"2356","2020","M04","April",113079,567613,0.199218481606306,2020-04-01,"Oakland County, MI",454534
"2357","2020","M05","May",118250,582523,0.20299627654187,2020-05-01,"Oakland County, MI",464273
"2358","2020","M06","June",100078,644770,0.155215037920499,2020-06-01,"Oakland County, MI",544692
"2359","2020","M07","July",61829,658874,0.093840400440752,2020-07-01,"Oakland County, MI",597045
"2360","2020","M08","August",55844,664580,0.0840290108038159,2020-08-01,"Oakland County, MI",608736
"2361","2020","M09","September",52785,662527,0.0796722246791452,2020-09-01,"Oakland County, MI",609742
"2362","2020","M10","October",48641,663580,0.0733008830887007,2020-10-01,"Oakland County, MI",614939
"2363","2020","M11","November",48411,660670,0.0732756141492727,2020-11-01,"Oakland County, MI",612259
"2364","2020","M12","December",53403,661576,0.0807208846753812,2020-12-01,"Oakland County, MI",608173
"2365","2021","M01","January",25736,634692,0.0405488016234646,2021-01-01,"Oakland County, MI",608956
"2366","2021","M02","February",20141,622078,0.0323769688045551,2021-02-01,"Oakland County, MI",601937
"2367","2021","M03","March",22354,633028,0.0353128139671547,2021-03-01,"Oakland County, MI",610674
"2368","2021","M04","April",17081,627342,0.0272275728390575,2021-04-01,"Oakland County, MI",610261
"2369","2021","M05","May",21409,637084,0.0336046737949784,2021-05-01,"Oakland County, MI",615675
"2370","2021","M06","June",23163,640783,0.0361479627268514,2021-06-01,"Oakland County, MI",617620
"2371","2021","M07","July",20911,651940,0.0320750375801454,2021-07-01,"Oakland County, MI",631029
"2372","2021","M08","August",17919,652369,0.02746758353018,2021-08-01,"Oakland County, MI",634450
"2373","2021","M09","September",26328,650400,0.040479704797048,2021-09-01,"Oakland County, MI",624072
"2374","2021","M10","October",21832,655063,0.0333280921071714,2021-10-01,"Oakland County, MI",633231
"2375","2021","M11","November",18722,657539,0.028472835831791,2021-11-01,"Oakland County, MI",638817
"2376","2021","M12","December",21699,658302,0.0329620751569948,2021-12-01,"Oakland County, MI",636603
"2377","2020","M01","January",7864,214938,0.0365872949408667,2020-01-01,"Oakland, CA",207074
"2378","2020","M02","February",7317,215825,0.0339024672767288,2020-02-01,"Oakland, CA",208508
"2379","2020","M03","March",8899,214884,0.0414130414549245,2020-03-01,"Oakland, CA",205985
"2380","2020","M04","April",34610,208579,0.165932332593406,2020-04-01,"Oakland, CA",173969
"2381","2020","M05","May",33249,209203,0.158931755280756,2020-05-01,"Oakland, CA",175954
"2382","2020","M06","June",32340,213011,0.151823145283577,2020-06-01,"Oakland, CA",180671
"2383","2020","M07","July",30617,212858,0.14383767582144,2020-07-01,"Oakland, CA",182241
"2384","2020","M08","August",27159,210550,0.128990738541914,2020-08-01,"Oakland, CA",183391
"2385","2020","M09","September",25065,209199,0.119814148251187,2020-09-01,"Oakland, CA",184134
"2386","2020","M10","October",22537,212411,0.106100908145058,2020-10-01,"Oakland, CA",189874
"2387","2020","M11","November",18091,208537,0.0867519912533507,2020-11-01,"Oakland, CA",190446
"2388","2020","M12","December",19710,210107,0.0938093447624306,2020-12-01,"Oakland, CA",190397
"2389","2021","M01","January",18397,208250,0.0883409363745498,2021-01-01,"Oakland, CA",189853
"2390","2021","M02","February",16749,209722,0.0798628660798581,2021-02-01,"Oakland, CA",192973
"2391","2021","M03","March",15803,208189,0.0759069883615369,2021-03-01,"Oakland, CA",192386
"2392","2021","M04","April",15200,205027,0.0741365771337434,2021-04-01,"Oakland, CA",189827
"2393","2021","M05","May",14380,206227,0.0697289879598695,2021-05-01,"Oakland, CA",191847
"2394","2021","M06","June",15969,207348,0.0770154522831182,2021-06-01,"Oakland, CA",191379
"2395","2021","M07","July",15934,209585,0.0760264331893981,2021-07-01,"Oakland, CA",193651
"2396","2021","M08","August",15124,208032,0.0727003537917243,2021-08-01,"Oakland, CA",192908
"2397","2021","M09","September",13105,208210,0.0629412612266462,2021-09-01,"Oakland, CA",195105
"2398","2021","M10","October",12743,209311,0.0608806990554725,2021-10-01,"Oakland, CA",196568
"2399","2021","M11","November",11214,209804,0.0534498865607901,2021-11-01,"Oakland, CA",198590
"2400","2021","M12","December",10216,209916,0.0486670858819718,2021-12-01,"Oakland, CA",199700
"2401","2020","M01","January",9375,219744,0.0426632809086938,2020-01-01,"Onondaga County, NY",210369
"2402","2020","M02","February",9557,218303,0.0437786013018603,2020-02-01,"Onondaga County, NY",208746
"2403","2020","M03","March",9876,218545,0.0451897778489556,2020-03-01,"Onondaga County, NY",208669
"2404","2020","M04","April",36637,213701,0.171440470564012,2020-04-01,"Onondaga County, NY",177064
"2405","2020","M05","May",27842,218566,0.127384863153464,2020-05-01,"Onondaga County, NY",190724
"2406","2020","M06","June",26577,225276,0.117975283652053,2020-06-01,"Onondaga County, NY",198699
"2407","2020","M07","July",27302,229591,0.118915811159845,2020-07-01,"Onondaga County, NY",202289
"2408","2020","M08","August",20343,226189,0.0899380606483958,2020-08-01,"Onondaga County, NY",205846
"2409","2020","M09","September",13853,219005,0.0632542636012876,2020-09-01,"Onondaga County, NY",205152
"2410","2020","M10","October",12664,217459,0.0582362652270083,2020-10-01,"Onondaga County, NY",204795
"2411","2020","M11","November",12991,219762,0.0591139505465003,2020-11-01,"Onondaga County, NY",206771
"2412","2020","M12","December",14336,219654,0.0652662824259972,2020-12-01,"Onondaga County, NY",205318
"2413","2021","M01","January",15326,217297,0.0705301959990244,2021-01-01,"Onondaga County, NY",201971
"2414","2021","M02","February",15679,216595,0.0723885592926891,2021-02-01,"Onondaga County, NY",200916
"2415","2021","M03","March",13968,216685,0.0644622378106468,2021-03-01,"Onondaga County, NY",202717
"2416","2021","M04","April",12001,216555,0.0554177922467733,2021-04-01,"Onondaga County, NY",204554
"2417","2021","M05","May",10782,214821,0.0501906238216934,2021-05-01,"Onondaga County, NY",204039
"2418","2021","M06","June",11691,218262,0.0535640652060368,2021-06-01,"Onondaga County, NY",206571
"2419","2021","M07","July",11919,219132,0.0543918733913805,2021-07-01,"Onondaga County, NY",207213
"2420","2021","M08","August",11477,216633,0.0529790013525179,2021-08-01,"Onondaga County, NY",205156
"2421","2021","M09","September",9487,214019,0.0443278400515842,2021-09-01,"Onondaga County, NY",204532
"2422","2021","M10","October",9037,212825,0.0424621167625984,2021-10-01,"Onondaga County, NY",203788
"2423","2021","M11","November",8032,211361,0.0380013342101901,2021-11-01,"Onondaga County, NY",203329
"2424","2021","M12","December",6115,211069,0.0289715685391981,2021-12-01,"Onondaga County, NY",204954
"2425","2020","M01","January",25505,765403,0.03332231517253,2020-01-01,"Orange County, FL",739898
"2426","2020","M02","February",22854,770175,0.0296737754406466,2020-02-01,"Orange County, FL",747321
"2427","2020","M03","March",39123,778591,0.0502484616441752,2020-03-01,"Orange County, FL",739468
"2428","2020","M04","April",135808,741391,0.183179995441002,2020-04-01,"Orange County, FL",605583
"2429","2020","M05","May",178094,760215,0.234267937359826,2020-05-01,"Orange County, FL",582121
"2430","2020","M06","June",144774,744975,0.194334038054968,2020-06-01,"Orange County, FL",600201
"2431","2020","M07","July",123420,747667,0.165073488598534,2020-07-01,"Orange County, FL",624247
"2432","2020","M08","August",81479,721833,0.112877909433345,2020-08-01,"Orange County, FL",640354
"2433","2020","M09","September",66281,719486,0.0921227098234017,2020-09-01,"Orange County, FL",653205
"2434","2020","M10","October",50780,709605,0.0715609388321672,2020-10-01,"Orange County, FL",658825
"2435","2020","M11","November",41879,700801,0.0597587617597578,2020-11-01,"Orange County, FL",658922
"2436","2020","M12","December",31959,690409,0.0462899527671279,2020-12-01,"Orange County, FL",658450
"2437","2021","M01","January",48452,703261,0.0688961850578946,2021-01-01,"Orange County, FL",654809
"2438","2021","M02","February",37266,701153,0.0531495978766403,2021-02-01,"Orange County, FL",663887
"2439","2021","M03","March",38922,709014,0.054895954099637,2021-03-01,"Orange County, FL",670092
"2440","2021","M04","April",40859,718218,0.056889412406818,2021-04-01,"Orange County, FL",677359
"2441","2021","M05","May",40440,729011,0.0554724139964966,2021-05-01,"Orange County, FL",688571
"2442","2021","M06","June",45107,744141,0.0606162004243819,2021-06-01,"Orange County, FL",699034
"2443","2021","M07","July",39941,749648,0.0532796725930036,2021-07-01,"Orange County, FL",709707
"2444","2021","M08","August",37715,751170,0.0502083416536869,2021-08-01,"Orange County, FL",713455
"2445","2021","M09","September",33695,754627,0.0446511985391458,2021-09-01,"Orange County, FL",720932
"2446","2021","M10","October",33089,757128,0.0437033104045815,2021-10-01,"Orange County, FL",724039
"2447","2021","M11","November",29665,755088,0.0392868116034158,2021-11-01,"Orange County, FL",725423
"2448","2021","M12","December",28267,752895,0.0375444119033863,2021-12-01,"Orange County, FL",724628
"2449","2020","M01","January",7059,187229,0.0377024926694048,2020-01-01,"Osceola County, FL",180170
"2450","2020","M02","February",6264,188290,0.0332678315364597,2020-02-01,"Osceola County, FL",182026
"2451","2020","M03","March",10680,190744,0.0559912762655706,2020-03-01,"Osceola County, FL",180064
"2452","2020","M04","April",42872,190406,0.225160971818115,2020-04-01,"Osceola County, FL",147534
"2453","2020","M05","May",62622,204394,0.306378856522207,2020-05-01,"Osceola County, FL",141772
"2454","2020","M06","June",49226,195557,0.251722004326104,2020-06-01,"Osceola County, FL",146331
"2455","2020","M07","July",38839,191127,0.203210430760698,2020-07-01,"Osceola County, FL",152288
"2456","2020","M08","August",25870,182128,0.142042958798208,2020-08-01,"Osceola County, FL",156258
"2457","2020","M09","September",20655,180021,0.114736614061693,2020-09-01,"Osceola County, FL",159366
"2458","2020","M10","October",15498,176122,0.0879958210785705,2020-10-01,"Osceola County, FL",160624
"2459","2020","M11","November",12753,173444,0.0735280551647794,2020-11-01,"Osceola County, FL",160691
"2460","2020","M12","December",9527,170063,0.0560204159634959,2020-12-01,"Osceola County, FL",160536
"2461","2021","M01","January",14682,174235,0.0842655034866703,2021-01-01,"Osceola County, FL",159553
"2462","2021","M02","February",10557,172342,0.0612561070429727,2021-02-01,"Osceola County, FL",161785
"2463","2021","M03","March",11156,174429,0.0639572548142797,2021-03-01,"Osceola County, FL",163273
"2464","2021","M04","April",11921,176992,0.0673533267040318,2021-04-01,"Osceola County, FL",165071
"2465","2021","M05","May",11803,179517,0.0657486477603792,2021-05-01,"Osceola County, FL",167714
"2466","2021","M06","June",13170,183636,0.0717179637979481,2021-06-01,"Osceola County, FL",170466
"2467","2021","M07","July",11713,184843,0.0633672900786073,2021-07-01,"Osceola County, FL",173130
"2468","2021","M08","August",11063,185200,0.0597354211663067,2021-08-01,"Osceola County, FL",174137
"2469","2021","M09","September",10036,185985,0.0539613409683577,2021-09-01,"Osceola County, FL",175949
"2470","2021","M10","October",9879,186450,0.0529847144006436,2021-10-01,"Osceola County, FL",176571
"2471","2021","M11","November",8907,185922,0.0479071868848227,2021-11-01,"Osceola County, FL",177015
"2472","2021","M12","December",8390,185196,0.0453033542841098,2021-12-01,"Osceola County, FL",176806
"2473","2020","M01","January",26771,747078,0.0358342770098972,2020-01-01,"Palm Beach County, FL",720307
"2474","2020","M02","February",24447,751184,0.0325446228886664,2020-02-01,"Palm Beach County, FL",726737
"2475","2020","M03","March",41024,759487,0.0540154077686649,2020-03-01,"Palm Beach County, FL",718463
"2476","2020","M04","April",99967,680750,0.146848329048843,2020-04-01,"Palm Beach County, FL",580783
"2477","2020","M05","May",101258,707709,0.143078581733453,2020-05-01,"Palm Beach County, FL",606451
"2478","2020","M06","June",81418,706397,0.115258133882222,2020-06-01,"Palm Beach County, FL",624979
"2479","2020","M07","July",82702,716980,0.11534770844375,2020-07-01,"Palm Beach County, FL",634278
"2480","2020","M08","August",56972,701601,0.0812028489127011,2020-08-01,"Palm Beach County, FL",644629
"2481","2020","M09","September",46619,708512,0.0657984621290818,2020-09-01,"Palm Beach County, FL",661893
"2482","2020","M10","October",36424,711009,0.0512286061076583,2020-10-01,"Palm Beach County, FL",674585
"2483","2020","M11","November",30809,707214,0.0435639000359156,2020-11-01,"Palm Beach County, FL",676405
"2484","2020","M12","December",24801,710625,0.0349002638522427,2020-12-01,"Palm Beach County, FL",685824
"2485","2021","M01","January",34834,725399,0.0480204687351375,2021-01-01,"Palm Beach County, FL",690565
"2486","2021","M02","February",32520,730845,0.0444964390534245,2021-02-01,"Palm Beach County, FL",698325
"2487","2021","M03","March",34706,735213,0.0472053676961642,2021-03-01,"Palm Beach County, FL",700507
"2488","2021","M04","April",35046,741754,0.0472474701855332,2021-04-01,"Palm Beach County, FL",706708
"2489","2021","M05","May",34265,748467,0.0457802414802523,2021-05-01,"Palm Beach County, FL",714202
"2490","2021","M06","June",40325,753478,0.0535184836186325,2021-06-01,"Palm Beach County, FL",713153
"2491","2021","M07","July",36717,757545,0.0484684078173574,2021-07-01,"Palm Beach County, FL",720828
"2492","2021","M08","August",35244,755087,0.0466754162103175,2021-08-01,"Palm Beach County, FL",719843
"2493","2021","M09","September",30810,748066,0.041186205495237,2021-09-01,"Palm Beach County, FL",717256
"2494","2021","M10","October",30076,755046,0.039833334657756,2021-10-01,"Palm Beach County, FL",724970
"2495","2021","M11","November",26668,754743,0.0353338818644227,2021-11-01,"Palm Beach County, FL",728075
"2496","2021","M12","December",25223,760237,0.033177811656102,2021-12-01,"Palm Beach County, FL",735014
"2497","2020","M01","January",9724,243356,0.0399579217278391,2020-01-01,"Pasco County, FL",233632
"2498","2020","M02","February",8711,244755,0.0355906927335499,2020-02-01,"Pasco County, FL",236044
"2499","2020","M03","March",14352,248049,0.0578595358175199,2020-03-01,"Pasco County, FL",233697
"2500","2020","M04","April",32332,230728,0.140130369959433,2020-04-01,"Pasco County, FL",198396
"2501","2020","M05","May",31391,236116,0.132947364854563,2020-05-01,"Pasco County, FL",204725
"2502","2020","M06","June",24366,235274,0.103564354752331,2020-06-01,"Pasco County, FL",210908
"2503","2020","M07","July",24448,238760,0.102395711174401,2020-07-01,"Pasco County, FL",214312
"2504","2020","M08","August",16471,236011,0.0697891199986441,2020-08-01,"Pasco County, FL",219540
"2505","2020","M09","September",13957,237255,0.0588270004847105,2020-09-01,"Pasco County, FL",223298
"2506","2020","M10","October",11473,237079,0.048393151649872,2020-10-01,"Pasco County, FL",225606
"2507","2020","M11","November",10154,236624,0.0429119615930759,2020-11-01,"Pasco County, FL",226470
"2508","2020","M12","December",8321,235917,0.0352708791651301,2020-12-01,"Pasco County, FL",227596
"2509","2021","M01","January",10945,239225,0.0457519072003344,2021-01-01,"Pasco County, FL",228280
"2510","2021","M02","February",11168,243325,0.0458974622418576,2021-02-01,"Pasco County, FL",232157
"2511","2021","M03","March",12159,245494,0.049528705385875,2021-03-01,"Pasco County, FL",233335
"2512","2021","M04","April",12377,247721,0.0499634669648516,2021-04-01,"Pasco County, FL",235344
"2513","2021","M05","May",12059,249605,0.0483123334869093,2021-05-01,"Pasco County, FL",237546
"2514","2021","M06","June",14123,253904,0.0556233852164598,2021-06-01,"Pasco County, FL",239781
"2515","2021","M07","July",12657,254490,0.0497347636449369,2021-07-01,"Pasco County, FL",241833
"2516","2021","M08","August",12038,254059,0.0473826945709461,2021-08-01,"Pasco County, FL",242021
"2517","2021","M09","September",10407,254865,0.0408333823789065,2021-09-01,"Pasco County, FL",244458
"2518","2021","M10","October",10328,255087,0.0404881471811578,2021-10-01,"Pasco County, FL",244759
"2519","2021","M11","November",9398,253705,0.0370430224079147,2021-11-01,"Pasco County, FL",244307
"2520","2021","M12","December",8928,254387,0.0350961330571138,2021-12-01,"Pasco County, FL",245459
"2521","2020","M01","January",42846,733679,0.0583988365484088,2020-01-01,"Philadelphia County, PA",690833
"2522","2020","M02","February",43050,737799,0.0583492251954801,2020-02-01,"Philadelphia County, PA",694749
"2523","2020","M03","March",48987,732383,0.0668871341907172,2020-03-01,"Philadelphia County, PA",683396
"2524","2020","M04","April",126511,722086,0.175202122738843,2020-04-01,"Philadelphia County, PA",595575
"2525","2020","M05","May",126878,734375,0.172770042553191,2020-05-01,"Philadelphia County, PA",607497
"2526","2020","M06","June",136382,739660,0.184384717302544,2020-06-01,"Philadelphia County, PA",603278
"2527","2020","M07","July",145632,748571,0.194546676267181,2020-07-01,"Philadelphia County, PA",602939
"2528","2020","M08","August",111667,717290,0.155679014066835,2020-08-01,"Philadelphia County, PA",605623
"2529","2020","M09","September",78481,713065,0.110061495095118,2020-09-01,"Philadelphia County, PA",634584
"2530","2020","M10","October",71522,707711,0.101061026322892,2020-10-01,"Philadelphia County, PA",636189
"2531","2020","M11","November",71731,705264,0.101708012885955,2020-11-01,"Philadelphia County, PA",633533
"2532","2020","M12","December",70659,695374,0.101612944976372,2020-12-01,"Philadelphia County, PA",624715
"2533","2021","M01","January",78587,698987,0.112429844904126,2021-01-01,"Philadelphia County, PA",620400
"2534","2021","M02","February",79573,711762,0.11179720187366,2021-02-01,"Philadelphia County, PA",632189
"2535","2021","M03","March",74712,705270,0.105933897656217,2021-03-01,"Philadelphia County, PA",630558
"2536","2021","M04","April",65776,695719,0.0945439178748891,2021-04-01,"Philadelphia County, PA",629943
"2537","2021","M05","May",58304,688632,0.0846664110874894,2021-05-01,"Philadelphia County, PA",630328
"2538","2021","M06","June",65662,699533,0.0938654788265886,2021-06-01,"Philadelphia County, PA",633871
"2539","2021","M07","July",66201,700227,0.0945421984584999,2021-07-01,"Philadelphia County, PA",634026
"2540","2021","M08","August",65738,696646,0.0943635648521631,2021-08-01,"Philadelphia County, PA",630908
"2541","2021","M09","September",56028,695286,0.0805826667011848,2021-09-01,"Philadelphia County, PA",639258
"2542","2021","M10","October",50248,694879,0.0723118701241511,2021-10-01,"Philadelphia County, PA",644631
"2543","2021","M11","November",45133,689708,0.0654378374616504,2021-11-01,"Philadelphia County, PA",644575
"2544","2021","M12","December",39624,679395,0.0583224780871216,2021-12-01,"Philadelphia County, PA",639771
"2545","2020","M01","January",42846,733679,0.0583988365484088,2020-01-01,"Philadelphia, PA",690833
"2546","2020","M02","February",43050,737799,0.0583492251954801,2020-02-01,"Philadelphia, PA",694749
"2547","2020","M03","March",48987,732383,0.0668871341907172,2020-03-01,"Philadelphia, PA",683396
"2548","2020","M04","April",126511,722086,0.175202122738843,2020-04-01,"Philadelphia, PA",595575
"2549","2020","M05","May",126878,734375,0.172770042553191,2020-05-01,"Philadelphia, PA",607497
"2550","2020","M06","June",136382,739660,0.184384717302544,2020-06-01,"Philadelphia, PA",603278
"2551","2020","M07","July",145632,748571,0.194546676267181,2020-07-01,"Philadelphia, PA",602939
"2552","2020","M08","August",111667,717290,0.155679014066835,2020-08-01,"Philadelphia, PA",605623
"2553","2020","M09","September",78481,713065,0.110061495095118,2020-09-01,"Philadelphia, PA",634584
"2554","2020","M10","October",71522,707711,0.101061026322892,2020-10-01,"Philadelphia, PA",636189
"2555","2020","M11","November",71731,705264,0.101708012885955,2020-11-01,"Philadelphia, PA",633533
"2556","2020","M12","December",70659,695374,0.101612944976372,2020-12-01,"Philadelphia, PA",624715
"2557","2021","M01","January",78587,698987,0.112429844904126,2021-01-01,"Philadelphia, PA",620400
"2558","2021","M02","February",79573,711762,0.11179720187366,2021-02-01,"Philadelphia, PA",632189
"2559","2021","M03","March",74712,705270,0.105933897656217,2021-03-01,"Philadelphia, PA",630558
"2560","2021","M04","April",65776,695719,0.0945439178748891,2021-04-01,"Philadelphia, PA",629943
"2561","2021","M05","May",58304,688632,0.0846664110874894,2021-05-01,"Philadelphia, PA",630328
"2562","2021","M06","June",65662,699533,0.0938654788265886,2021-06-01,"Philadelphia, PA",633871
"2563","2021","M07","July",66201,700227,0.0945421984584999,2021-07-01,"Philadelphia, PA",634026
"2564","2021","M08","August",65738,696646,0.0943635648521631,2021-08-01,"Philadelphia, PA",630908
"2565","2021","M09","September",56028,695286,0.0805826667011848,2021-09-01,"Philadelphia, PA",639258
"2566","2021","M10","October",50248,694879,0.0723118701241511,2021-10-01,"Philadelphia, PA",644631
"2567","2021","M11","November",45133,689708,0.0654378374616504,2021-11-01,"Philadelphia, PA",644575
"2568","2021","M12","December",39624,679395,0.0583224780871216,2021-12-01,"Philadelphia, PA",639771
"2569","2020","M01","January",37209,874370,0.0425552111806215,2020-01-01,"Phoenix, AZ",837161
"2570","2020","M02","February",35496,877343,0.0404585207837756,2020-02-01,"Phoenix, AZ",841847
"2571","2020","M03","March",40497,872675,0.0464055920016043,2020-03-01,"Phoenix, AZ",832178
"2572","2020","M04","April",120377,863011,0.139484896484518,2020-04-01,"Phoenix, AZ",742634
"2573","2020","M05","May",95899,889351,0.107830316714098,2020-05-01,"Phoenix, AZ",793452
"2574","2020","M06","June",97219,877636,0.110773714843056,2020-06-01,"Phoenix, AZ",780417
"2575","2020","M07","July",100325,892177,0.112449659652737,2020-07-01,"Phoenix, AZ",791852
"2576","2020","M08","August",64175,866863,0.0740313059849134,2020-08-01,"Phoenix, AZ",802688
"2577","2020","M09","September",64547,875036,0.0737649650985788,2020-09-01,"Phoenix, AZ",810489
"2578","2020","M10","October",60175,874627,0.0688007573514195,2020-10-01,"Phoenix, AZ",814452
"2579","2020","M11","November",60539,880347,0.0687672020237474,2020-11-01,"Phoenix, AZ",819808
"2580","2020","M12","December",62166,879665,0.0706700846344915,2020-12-01,"Phoenix, AZ",817499
"2581","2021","M01","January",63223,880337,0.0718168156058419,2021-01-01,"Phoenix, AZ",817114
"2582","2021","M02","February",64921,885564,0.073310342335506,2021-02-01,"Phoenix, AZ",820643
"2583","2021","M03","March",58442,885340,0.06601079811146,2021-03-01,"Phoenix, AZ",826898
"2584","2021","M04","April",58308,889425,0.0655569609579223,2021-04-01,"Phoenix, AZ",831117
"2585","2021","M05","May",59999,895244,0.0670197175295227,2021-05-01,"Phoenix, AZ",835245
"2586","2021","M06","June",64074,903199,0.0709411768613561,2021-06-01,"Phoenix, AZ",839125
"2587","2021","M07","July",55701,901616,0.0617790722436159,2021-07-01,"Phoenix, AZ",845915
"2588","2021","M08","August",46305,895365,0.051716339146605,2021-08-01,"Phoenix, AZ",849060
"2589","2021","M09","September",37466,900453,0.0416079462226235,2021-09-01,"Phoenix, AZ",862987
"2590","2021","M10","October",31061,899607,0.0345272991428479,2021-10-01,"Phoenix, AZ",868546
"2591","2021","M11","November",26636,902570,0.0295112844433119,2021-11-01,"Phoenix, AZ",875934
"2592","2021","M12","December",23170,899909,0.025747047757051,2021-12-01,"Phoenix, AZ",876739
"2593","2020","M01","January",24614,455060,0.0540895706060739,2020-01-01,"Pierce County, WA",430446
"2594","2020","M02","February",24580,457917,0.0536778499160328,2020-02-01,"Pierce County, WA",433337
"2595","2020","M03","March",27956,456672,0.0612168033074066,2020-03-01,"Pierce County, WA",428716
"2596","2020","M04","April",88467,475972,0.185865975309472,2020-04-01,"Pierce County, WA",387505
"2597","2020","M05","May",66333,454547,0.145932103830847,2020-05-01,"Pierce County, WA",388214
"2598","2020","M06","June",54701,444903,0.122950395929,2020-06-01,"Pierce County, WA",390202
"2599","2020","M07","July",57168,450238,0.126972845472839,2020-07-01,"Pierce County, WA",393070
"2600","2020","M08","August",44669,439311,0.101679675673953,2020-08-01,"Pierce County, WA",394642
"2601","2020","M09","September",37615,435661,0.086340067162312,2020-09-01,"Pierce County, WA",398046
"2602","2020","M10","October",31485,464720,0.0677504734033396,2020-10-01,"Pierce County, WA",433235
"2603","2020","M11","November",31860,436982,0.072909181613888,2020-11-01,"Pierce County, WA",405122
"2604","2020","M12","December",31043,430375,0.0721301190821958,2020-12-01,"Pierce County, WA",399332
"2605","2021","M01","January",30038,426036,0.0705057788543691,2021-01-01,"Pierce County, WA",395998
"2606","2021","M02","February",30392,429869,0.0707006087901198,2021-02-01,"Pierce County, WA",399477
"2607","2021","M03","March",30394,438003,0.0693922187747572,2021-03-01,"Pierce County, WA",407609
"2608","2021","M04","April",27784,437500,0.0635062857142857,2021-04-01,"Pierce County, WA",409716
"2609","2021","M05","May",23593,439016,0.0537406381544181,2021-05-01,"Pierce County, WA",415423
"2610","2021","M06","June",23797,438450,0.054275287946174,2021-06-01,"Pierce County, WA",414653
"2611","2021","M07","July",22415,442907,0.0506088185555884,2021-07-01,"Pierce County, WA",420492
"2612","2021","M08","August",23412,444189,0.0527072935169489,2021-08-01,"Pierce County, WA",420777
"2613","2021","M09","September",19998,443144,0.045127543191378,2021-09-01,"Pierce County, WA",423146
"2614","2021","M10","October",20116,442830,0.0454260099812569,2021-10-01,"Pierce County, WA",422714
"2615","2021","M11","November",18199,449317,0.0405036978347136,2021-11-01,"Pierce County, WA",431118
"2616","2021","M12","December",18740,451739,0.0414841313236183,2021-12-01,"Pierce County, WA",432999
"2617","2020","M01","January",23305,498831,0.0467192295587083,2020-01-01,"Pima County, AZ",475526
"2618","2020","M02","February",22004,503706,0.0436842126160895,2020-02-01,"Pima County, AZ",481702
"2619","2020","M03","March",25025,500907,0.0499593736961153,2020-03-01,"Pima County, AZ",475882
"2620","2020","M04","April",68383,492397,0.138877775453547,2020-04-01,"Pima County, AZ",424014
"2621","2020","M05","May",52404,505090,0.103751806608723,2020-05-01,"Pima County, AZ",452686
"2622","2020","M06","June",52344,495268,0.105688233441288,2020-06-01,"Pima County, AZ",442924
"2623","2020","M07","July",53274,499389,0.10667836095709,2020-07-01,"Pima County, AZ",446115
"2624","2020","M08","August",32862,486417,0.0675593163890242,2020-08-01,"Pima County, AZ",453555
"2625","2020","M09","September",33108,491929,0.0673023952643573,2020-09-01,"Pima County, AZ",458821
"2626","2020","M10","October",31286,489785,0.0638770072582868,2020-10-01,"Pima County, AZ",458499
"2627","2020","M11","November",31845,494410,0.0644101049736049,2020-11-01,"Pima County, AZ",462565
"2628","2020","M12","December",33851,493760,0.0685575988334413,2020-12-01,"Pima County, AZ",459909
"2629","2021","M01","January",35361,495480,0.0713671591184306,2021-01-01,"Pima County, AZ",460119
"2630","2021","M02","February",36237,496831,0.0729362700797656,2021-02-01,"Pima County, AZ",460594
"2631","2021","M03","March",33056,499062,0.066236259222301,2021-03-01,"Pima County, AZ",466006
"2632","2021","M04","April",33031,500208,0.0660345296356716,2021-04-01,"Pima County, AZ",467177
"2633","2021","M05","May",33905,503693,0.067312827456407,2021-05-01,"Pima County, AZ",469788
"2634","2021","M06","June",36651,500768,0.0731895808038852,2021-06-01,"Pima County, AZ",464117
"2635","2021","M07","July",31914,495749,0.0643753189618133,2021-07-01,"Pima County, AZ",463835
"2636","2021","M08","August",26103,497250,0.0524947209653092,2021-08-01,"Pima County, AZ",471147
"2637","2021","M09","September",21561,500970,0.0430385052997185,2021-09-01,"Pima County, AZ",479409
"2638","2021","M10","October",18213,497200,0.0366311343523733,2021-10-01,"Pima County, AZ",478987
"2639","2021","M11","November",15923,500453,0.0318171736406815,2021-11-01,"Pima County, AZ",484530
"2640","2021","M12","December",13842,499312,0.0277221456724453,2021-12-01,"Pima County, AZ",485470
"2641","2020","M01","January",6347,188740,0.0336282716965137,2020-01-01,"Placer County, CA",182393
"2642","2020","M02","February",5956,189479,0.0314335625583838,2020-02-01,"Placer County, CA",183523
"2643","2020","M03","March",6881,188877,0.0364311165467474,2020-03-01,"Placer County, CA",181996
"2644","2020","M04","April",24108,182099,0.132389524379596,2020-04-01,"Placer County, CA",157991
"2645","2020","M05","May",22493,181288,0.124073297736199,2020-05-01,"Placer County, CA",158795
"2646","2020","M06","June",19281,184063,0.104752177243661,2020-06-01,"Placer County, CA",164782
"2647","2020","M07","July",17318,184405,0.0939128548575147,2020-07-01,"Placer County, CA",167087
"2648","2020","M08","August",14940,182517,0.0818553888130969,2020-08-01,"Placer County, CA",167577
"2649","2020","M09","September",13200,182109,0.0724840617432417,2020-09-01,"Placer County, CA",168909
"2650","2020","M10","October",11667,186307,0.0626224457481469,2020-10-01,"Placer County, CA",174640
"2651","2020","M11","November",9563,184108,0.0519423381927999,2020-11-01,"Placer County, CA",174545
"2652","2020","M12","December",11118,184709,0.0601919776513326,2020-12-01,"Placer County, CA",173591
"2653","2021","M01","January",11003,184451,0.0596526990908154,2021-01-01,"Placer County, CA",173448
"2654","2021","M02","February",10557,186655,0.0565588920736117,2021-02-01,"Placer County, CA",176098
"2655","2021","M03","March",10049,185311,0.0542277576614448,2021-03-01,"Placer County, CA",175262
"2656","2021","M04","April",9535,183097,0.0520762218933134,2021-04-01,"Placer County, CA",173562
"2657","2021","M05","May",8994,183900,0.0489070146818923,2021-05-01,"Placer County, CA",174906
"2658","2021","M06","June",10184,185657,0.0548538433778419,2021-06-01,"Placer County, CA",175473
"2659","2021","M07","July",9961,187272,0.0531900123883976,2021-07-01,"Placer County, CA",177311
"2660","2021","M08","August",9563,186790,0.0511965308635366,2021-08-01,"Placer County, CA",177227
"2661","2021","M09","September",7932,186767,0.0424700295019998,2021-09-01,"Placer County, CA",178835
"2662","2021","M10","October",7631,187545,0.0406889013303474,2021-10-01,"Placer County, CA",179914
"2663","2021","M11","November",6596,188377,0.0350148903528562,2021-11-01,"Placer County, CA",181781
"2664","2021","M12","December",6147,187522,0.032780153795288,2021-12-01,"Placer County, CA",181375
"2665","2020","M01","January",5063,163580,0.0309512165301382,2020-01-01,"Plano, TX",158517
"2666","2020","M02","February",4900,164596,0.0297698607499575,2020-02-01,"Plano, TX",159696
"2667","2020","M03","March",6803,160248,0.0424529479307074,2020-03-01,"Plano, TX",153445
"2668","2020","M04","April",17586,152533,0.115293084119502,2020-04-01,"Plano, TX",134947
"2669","2020","M05","May",15869,154754,0.102543391447071,2020-05-01,"Plano, TX",138885
"2670","2020","M06","June",14047,160884,0.0873113547649238,2020-06-01,"Plano, TX",146837
"2671","2020","M07","July",12392,160563,0.0771784284050497,2020-07-01,"Plano, TX",148171
"2672","2020","M08","August",8824,162822,0.0541941506676002,2020-08-01,"Plano, TX",153998
"2673","2020","M09","September",10105,161495,0.0625715966438589,2020-09-01,"Plano, TX",151390
"2674","2020","M10","October",8699,164052,0.0530258698461463,2020-10-01,"Plano, TX",155353
"2675","2020","M11","November",8697,162783,0.0534269549031533,2020-11-01,"Plano, TX",154086
"2676","2020","M12","December",8461,164410,0.0514628063986376,2020-12-01,"Plano, TX",155949
"2677","2021","M01","January",9567,163070,0.0586680566627829,2021-01-01,"Plano, TX",153503
"2678","2021","M02","February",9651,162417,0.0594211197103751,2021-02-01,"Plano, TX",152766
"2679","2021","M03","March",8854,162482,0.0544921899041125,2021-03-01,"Plano, TX",153628
"2680","2021","M04","April",8040,162707,0.0494139772720289,2021-04-01,"Plano, TX",154667
"2681","2021","M05","May",7491,163318,0.0458675712413818,2021-05-01,"Plano, TX",155827
"2682","2021","M06","June",8281,164551,0.0503248233070598,2021-06-01,"Plano, TX",156270
"2683","2021","M07","July",7480,166000,0.0450602409638554,2021-07-01,"Plano, TX",158520
"2684","2021","M08","August",6678,166391,0.0401343822682717,2021-08-01,"Plano, TX",159713
"2685","2021","M09","September",6357,166719,0.0381300271714682,2021-09-01,"Plano, TX",160362
"2686","2021","M10","October",6154,168095,0.0366102501561617,2021-10-01,"Plano, TX",161941
"2687","2021","M11","November",5906,170326,0.0346746826673555,2021-11-01,"Plano, TX",164420
"2688","2021","M12","December",5313,169807,0.0312884627842197,2021-12-01,"Plano, TX",164494
"2689","2020","M01","January",13008,312921,0.0415695974383311,2020-01-01,"Polk County, FL",299913
"2690","2020","M02","February",11558,314138,0.0367927471366088,2020-02-01,"Polk County, FL",302580
"2691","2020","M03","March",19071,320814,0.0594456601021152,2020-03-01,"Polk County, FL",301743
"2692","2020","M04","April",43625,308041,0.141620758275684,2020-04-01,"Polk County, FL",264416
"2693","2020","M05","May",60425,327886,0.184286611810202,2020-05-01,"Polk County, FL",267461
"2694","2020","M06","June",48884,321522,0.152039362780774,2020-06-01,"Polk County, FL",272638
"2695","2020","M07","July",42730,319892,0.133576332012054,2020-07-01,"Polk County, FL",277162
"2696","2020","M08","August",29475,315869,0.0933140004242265,2020-08-01,"Polk County, FL",286394
"2697","2020","M09","September",24964,318019,0.0784984544948572,2020-09-01,"Polk County, FL",293055
"2698","2020","M10","October",19609,314930,0.0622646302352904,2020-10-01,"Polk County, FL",295321
"2699","2020","M11","November",16936,313280,0.0540602655771195,2020-11-01,"Polk County, FL",296344
"2700","2020","M12","December",13478,312201,0.0431709059227869,2020-12-01,"Polk County, FL",298723
"2701","2021","M01","January",17865,317588,0.0562521253951661,2021-01-01,"Polk County, FL",299723
"2702","2021","M02","February",17251,321125,0.0537205138186065,2021-02-01,"Polk County, FL",303874
"2703","2021","M03","March",18056,324471,0.0556475000847533,2021-03-01,"Polk County, FL",306415
"2704","2021","M04","April",18988,326328,0.0581868549434924,2021-04-01,"Polk County, FL",307340
"2705","2021","M05","May",18917,327593,0.0577454341209977,2021-05-01,"Polk County, FL",308676
"2706","2021","M06","June",21887,330778,0.0661682457720888,2021-06-01,"Polk County, FL",308891
"2707","2021","M07","July",19856,330717,0.0600392480580073,2021-07-01,"Polk County, FL",310861
"2708","2021","M08","August",18625,330423,0.056367141512546,2021-08-01,"Polk County, FL",311798
"2709","2021","M09","September",16301,331641,0.0491525474835741,2021-09-01,"Polk County, FL",315340
"2710","2021","M10","October",16088,331723,0.0484982952644224,2021-10-01,"Polk County, FL",315635
"2711","2021","M11","November",14487,330839,0.0437886706222664,2021-11-01,"Polk County, FL",316352
"2712","2021","M12","December",13729,331896,0.041365367464507,2021-12-01,"Polk County, FL",318167
"2713","2020","M01","January",9503,272179,0.0349145231630655,2020-01-01,"Polk County, IA",262676
"2714","2020","M02","February",8506,272352,0.0312316414052403,2020-02-01,"Polk County, IA",263846
"2715","2020","M03","March",9445,268874,0.0351279781607742,2020-03-01,"Polk County, IA",259429
"2716","2020","M04","April",35615,272148,0.130866293340388,2020-04-01,"Polk County, IA",236533
"2717","2020","M05","May",25809,262909,0.098167046392478,2020-05-01,"Polk County, IA",237100
"2718","2020","M06","June",23242,265854,0.0874239244096384,2020-06-01,"Polk County, IA",242612
"2719","2020","M07","July",18033,265527,0.0679139974465874,2020-07-01,"Polk County, IA",247494
"2720","2020","M08","August",14979,261964,0.057179612465835,2020-08-01,"Polk County, IA",246985
"2721","2020","M09","September",13107,260620,0.0502916123091091,2020-09-01,"Polk County, IA",247513
"2722","2020","M10","October",10370,260574,0.0397967563916584,2020-10-01,"Polk County, IA",250204
"2723","2020","M11","November",10479,258403,0.0405529347569494,2020-11-01,"Polk County, IA",247924
"2724","2020","M12","December",11420,256277,0.0445611584340382,2020-12-01,"Polk County, IA",244857
"2725","2021","M01","January",13145,257810,0.0509871610876227,2021-01-01,"Polk County, IA",244665
"2726","2021","M02","February",13865,261535,0.0530139369491655,2021-02-01,"Polk County, IA",247670
"2727","2021","M03","March",12257,262360,0.046718249733191,2021-03-01,"Polk County, IA",250103
"2728","2021","M04","April",11522,265907,0.0433309390125119,2021-04-01,"Polk County, IA",254385
"2729","2021","M05","May",12019,266525,0.0450952068286277,2021-05-01,"Polk County, IA",254506
"2730","2021","M06","June",13724,271429,0.0505620254283809,2021-06-01,"Polk County, IA",257705
"2731","2021","M07","July",11572,274639,0.0421353121734349,2021-07-01,"Polk County, IA",263067
"2732","2021","M08","August",10781,269566,0.0399939161466951,2021-08-01,"Polk County, IA",258785
"2733","2021","M09","September",8343,267893,0.031143030986252,2021-09-01,"Polk County, IA",259550
"2734","2021","M10","October",8177,269861,0.0303007844779349,2021-10-01,"Polk County, IA",261684
"2735","2021","M11","November",7461,268645,0.0277727111987939,2021-11-01,"Polk County, IA",261184
"2736","2021","M12","December",7822,267554,0.0292352198060952,2021-12-01,"Polk County, IA",259732
"2737","2020","M01","January",11666,374845,0.0311221971748323,2020-01-01,"Portland, OR",363179
"2738","2020","M02","February",11439,377385,0.0303112206367503,2020-02-01,"Portland, OR",365946
"2739","2020","M03","March",14069,375122,0.037505131663832,2020-03-01,"Portland, OR",361053
"2740","2020","M04","April",53232,369414,0.14409849112378,2020-04-01,"Portland, OR",316182
"2741","2020","M05","May",51217,381903,0.134109970332781,2020-05-01,"Portland, OR",330686
"2742","2020","M06","June",49692,387068,0.128380542953693,2020-06-01,"Portland, OR",337376
"2743","2020","M07","July",46075,371834,0.123912821312736,2020-07-01,"Portland, OR",325759
"2744","2020","M08","August",40444,381999,0.105874622708436,2020-08-01,"Portland, OR",341555
"2745","2020","M09","September",34343,380083,0.0903565800101557,2020-09-01,"Portland, OR",345740
"2746","2020","M10","October",29628,382172,0.0775253027432674,2020-10-01,"Portland, OR",352544
"2747","2020","M11","November",27415,383673,0.0714540767789237,2020-11-01,"Portland, OR",356258
"2748","2020","M12","December",25879,381311,0.0678684853046463,2020-12-01,"Portland, OR",355432
"2749","2021","M01","January",27983,379710,0.0736957151510363,2021-01-01,"Portland, OR",351727
"2750","2021","M02","February",26282,381421,0.0689054876370205,2021-02-01,"Portland, OR",355139
"2751","2021","M03","March",27006,384804,0.0701811831477843,2021-03-01,"Portland, OR",357798
"2752","2021","M04","April",23838,384140,0.06205550059874,2021-04-01,"Portland, OR",360302
"2753","2021","M05","May",21292,384495,0.0553765328547835,2021-05-01,"Portland, OR",363203
"2754","2021","M06","June",20743,384638,0.053928628996615,2021-06-01,"Portland, OR",363895
"2755","2021","M07","July",19480,388851,0.0500963093832856,2021-07-01,"Portland, OR",369371
"2756","2021","M08","August",17843,387631,0.04603089020228,2021-08-01,"Portland, OR",369788
"2757","2021","M09","September",16639,387635,0.0429244005314278,2021-09-01,"Portland, OR",370996
"2758","2021","M10","October",13709,388481,0.0352887271192156,2021-10-01,"Portland, OR",374772
"2759","2021","M11","November",13593,390653,0.0347955858524061,2021-11-01,"Portland, OR",377060
"2760","2021","M12","December",14068,390784,0.0359994267933181,2021-12-01,"Portland, OR",376716
"2761","2020","M01","January",19105,515913,0.0370314374710465,2020-01-01,"Prince George's County, MD",496808
"2762","2020","M02","February",18290,522032,0.0350361663652803,2020-02-01,"Prince George's County, MD",503742
"2763","2020","M03","March",21328,520176,0.0410015071821845,2020-03-01,"Prince George's County, MD",498848
"2764","2020","M04","April",43922,492623,0.0891594586529659,2020-04-01,"Prince George's County, MD",448701
"2765","2020","M05","May",52557,497249,0.105695536843714,2020-05-01,"Prince George's County, MD",444692
"2766","2020","M06","June",54508,516206,0.10559350336881,2020-06-01,"Prince George's County, MD",461698
"2767","2020","M07","July",55596,508069,0.109426081890452,2020-07-01,"Prince George's County, MD",452473
"2768","2020","M08","August",55186,507619,0.108715394813827,2020-08-01,"Prince George's County, MD",452433
"2769","2020","M09","September",43452,480502,0.0904304248473471,2020-09-01,"Prince George's County, MD",437050
"2770","2020","M10","October",44152,498935,0.0884924890015733,2020-10-01,"Prince George's County, MD",454783
"2771","2020","M11","November",45370,498645,0.0909865736144953,2020-11-01,"Prince George's County, MD",453275
"2772","2020","M12","December",43296,493343,0.0877604425318693,2020-12-01,"Prince George's County, MD",450047
"2773","2021","M01","January",38523,486500,0.0791839671120247,2021-01-01,"Prince George's County, MD",447977
"2774","2021","M02","February",37317,487847,0.0764932448083108,2021-02-01,"Prince George's County, MD",450530
"2775","2021","M03","March",38560,490159,0.0786683504740299,2021-03-01,"Prince George's County, MD",451599
"2776","2021","M04","April",39592,491874,0.0804921585609323,2021-04-01,"Prince George's County, MD",452282
"2777","2021","M05","May",38004,490173,0.0775318101976241,2021-05-01,"Prince George's County, MD",452169
"2778","2021","M06","June",41199,494186,0.0833673960816373,2021-06-01,"Prince George's County, MD",452987
"2779","2021","M07","July",39773,502383,0.0791686820612959,2021-07-01,"Prince George's County, MD",462610
"2780","2021","M08","August",40202,494615,0.0812793789108701,2021-08-01,"Prince George's County, MD",454413
"2781","2021","M09","September",33116,491658,0.0673557635592221,2021-09-01,"Prince George's County, MD",458542
"2782","2021","M10","October",30923,492409,0.0627994208066871,2021-10-01,"Prince George's County, MD",461486
"2783","2021","M11","November",29760,491518,0.0605471213668675,2021-11-01,"Prince George's County, MD",461758
"2784","2021","M12","December",24572,488116,0.0503404928336707,2021-12-01,"Prince George's County, MD",463544
"2785","2020","M01","January",8388,258245,0.0324807837518635,2020-01-01,"Raleigh, NC",249857
"2786","2020","M02","February",7954,260298,0.0305572843433296,2020-02-01,"Raleigh, NC",252344
"2787","2020","M03","March",9077,249465,0.0363858657527108,2020-03-01,"Raleigh, NC",240388
"2788","2020","M04","April",31128,238562,0.130481803472473,2020-04-01,"Raleigh, NC",207434
"2789","2020","M05","May",34874,247058,0.141157137190457,2020-05-01,"Raleigh, NC",212184
"2790","2020","M06","June",23293,248020,0.0939158132408677,2020-06-01,"Raleigh, NC",224727
"2791","2020","M07","July",24409,256990,0.0949803494299389,2020-07-01,"Raleigh, NC",232581
"2792","2020","M08","August",17806,252833,0.0704259333235772,2020-08-01,"Raleigh, NC",235027
"2793","2020","M09","September",18310,256420,0.0714062865611107,2020-09-01,"Raleigh, NC",238110
"2794","2020","M10","October",16478,258534,0.0637362977403359,2020-10-01,"Raleigh, NC",242056
"2795","2020","M11","November",15853,258588,0.0613060157470571,2020-11-01,"Raleigh, NC",242735
"2796","2020","M12","December",15125,257719,0.0586879508301677,2020-12-01,"Raleigh, NC",242594
"2797","2021","M01","January",14171,255611,0.0554397111235432,2021-01-01,"Raleigh, NC",241440
"2798","2021","M02","February",13310,256923,0.0518054047321571,2021-02-01,"Raleigh, NC",243613
"2799","2021","M03","March",10865,257025,0.0422721525143469,2021-03-01,"Raleigh, NC",246160
"2800","2021","M04","April",10377,256198,0.0405038290697039,2021-04-01,"Raleigh, NC",245821
"2801","2021","M05","May",10676,255018,0.0418637115811433,2021-05-01,"Raleigh, NC",244342
"2802","2021","M06","June",11673,259110,0.0450503647099687,2021-06-01,"Raleigh, NC",247437
"2803","2021","M07","July",11166,261616,0.0426808757874136,2021-07-01,"Raleigh, NC",250450
"2804","2021","M08","August",10593,260678,0.0406363406194616,2021-08-01,"Raleigh, NC",250085
"2805","2021","M09","September",9043,261778,0.0345445377380834,2021-09-01,"Raleigh, NC",252735
"2806","2021","M10","October",8878,262979,0.0337593496058621,2021-10-01,"Raleigh, NC",254101
"2807","2021","M11","November",8090,263067,0.0307526219556235,2021-11-01,"Raleigh, NC",254977
"2808","2021","M12","December",7500,262887,0.0285293681315546,2021-12-01,"Raleigh, NC",255387
"2809","2020","M01","January",8570,290429,0.0295080725409653,2020-01-01,"Ramsey County, MN",281859
"2810","2020","M02","February",8487,292148,0.0290503443460164,2020-02-01,"Ramsey County, MN",283661
"2811","2020","M03","March",11529,291810,0.0395085843528323,2020-03-01,"Ramsey County, MN",280281
"2812","2020","M04","April",27470,280387,0.0979717319276571,2020-04-01,"Ramsey County, MN",252917
"2813","2020","M05","May",36863,290351,0.126960127569735,2020-05-01,"Ramsey County, MN",253488
"2814","2020","M06","June",31737,301056,0.105418925382653,2020-06-01,"Ramsey County, MN",269319
"2815","2020","M07","July",28042,298787,0.0938528115346384,2020-07-01,"Ramsey County, MN",270745
"2816","2020","M08","August",23612,295757,0.0798358111557799,2020-08-01,"Ramsey County, MN",272145
"2817","2020","M09","September",20687,290809,0.0711360377429859,2020-09-01,"Ramsey County, MN",270122
"2818","2020","M10","October",15907,285607,0.0556954136278172,2020-10-01,"Ramsey County, MN",269700
"2819","2020","M11","November",13651,284052,0.0480581020376551,2020-11-01,"Ramsey County, MN",270401
"2820","2020","M12","December",14215,280983,0.05059024923216,2020-12-01,"Ramsey County, MN",266768
"2821","2021","M01","January",13929,278054,0.0500945859437376,2021-01-01,"Ramsey County, MN",264125
"2822","2021","M02","February",13426,280606,0.0478464466191029,2021-02-01,"Ramsey County, MN",267180
"2823","2021","M03","March",12674,281295,0.0450559021667644,2021-03-01,"Ramsey County, MN",268621
"2824","2021","M04","April",13147,283983,0.0462950247021829,2021-04-01,"Ramsey County, MN",270836
"2825","2021","M05","May",12517,285797,0.0437968208203725,2021-05-01,"Ramsey County, MN",273280
"2826","2021","M06","June",14758,286182,0.051568582230888,2021-06-01,"Ramsey County, MN",271424
"2827","2021","M07","July",11692,285975,0.0408846927178949,2021-07-01,"Ramsey County, MN",274283
"2828","2021","M08","August",11498,284785,0.0403743174675633,2021-08-01,"Ramsey County, MN",273287
"2829","2021","M09","September",9734,283840,0.03429396843292,2021-09-01,"Ramsey County, MN",274106
"2830","2021","M10","October",8512,281943,0.0301904994981255,2021-10-01,"Ramsey County, MN",273431
"2831","2021","M11","November",6917,282912,0.024449298721864,2021-11-01,"Ramsey County, MN",275995
"2832","2021","M12","December",7656,281720,0.0271759193525486,2021-12-01,"Ramsey County, MN",274064
"2833","2020","M01","January",4875,142032,0.034323251098344,2020-01-01,"Reno, NV",137157
"2834","2020","M02","February",4311,143980,0.0299416585636894,2020-02-01,"Reno, NV",139669
"2835","2020","M03","March",7464,140470,0.0531359009041076,2020-03-01,"Reno, NV",133006
"2836","2020","M04","April",26535,130721,0.202989573213179,2020-04-01,"Reno, NV",104186
"2837","2020","M05","May",20808,128167,0.162350683093152,2020-05-01,"Reno, NV",107359
"2838","2020","M06","June",12210,136358,0.0895437011396471,2020-06-01,"Reno, NV",124148
"2839","2020","M07","July",13472,134933,0.0998421438788139,2020-07-01,"Reno, NV",121461
"2840","2020","M08","August",11086,137375,0.0806988171064604,2020-08-01,"Reno, NV",126289
"2841","2020","M09","September",9914,139973,0.070827945389468,2020-09-01,"Reno, NV",130059
"2842","2020","M10","October",8812,141546,0.0622553798765066,2020-10-01,"Reno, NV",132734
"2843","2020","M11","November",6386,141377,0.0451700064366906,2020-11-01,"Reno, NV",134991
"2844","2020","M12","December",6307,142120,0.044377990430622,2020-12-01,"Reno, NV",135813
"2845","2021","M01","January",6845,143663,0.0476462276299395,2021-01-01,"Reno, NV",136818
"2846","2021","M02","February",7135,146735,0.0486250724094456,2021-02-01,"Reno, NV",139600
"2847","2021","M03","March",6739,145507,0.0463139230415032,2021-03-01,"Reno, NV",138768
"2848","2021","M04","April",7061,145043,0.0486821149590122,2021-04-01,"Reno, NV",137982
"2849","2021","M05","May",6777,145067,0.0467163448613399,2021-05-01,"Reno, NV",138290
"2850","2021","M06","June",7151,143943,0.0496793869795683,2021-06-01,"Reno, NV",136792
"2851","2021","M07","July",7126,142222,0.0501047657886965,2021-07-01,"Reno, NV",135096
"2852","2021","M08","August",6066,141436,0.0428886563534037,2021-08-01,"Reno, NV",135370
"2853","2021","M09","September",5045,141443,0.0356680783071626,2021-09-01,"Reno, NV",136398
"2854","2021","M10","October",4602,143410,0.0320898124259117,2021-10-01,"Reno, NV",138808
"2855","2021","M11","November",4114,142880,0.0287933930571109,2021-11-01,"Reno, NV",138766
"2856","2021","M12","December",4018,142480,0.0282004491858506,2021-12-01,"Reno, NV",138462
"2857","2020","M01","January",6196,189469,0.0327019195752339,2020-01-01,"Rockingham County, NH",183273
"2858","2020","M02","February",6037,187853,0.0321368303939783,2020-02-01,"Rockingham County, NH",181816
"2859","2020","M03","March",6346,186865,0.0339603457041179,2020-03-01,"Rockingham County, NH",180519
"2860","2020","M04","April",30471,177978,0.171206553618987,2020-04-01,"Rockingham County, NH",147507
"2861","2020","M05","May",26679,185387,0.143909767135775,2020-05-01,"Rockingham County, NH",158708
"2862","2020","M06","June",20145,188190,0.107046070460705,2020-06-01,"Rockingham County, NH",168045
"2863","2020","M07","July",16095,188969,0.0851727002841736,2020-07-01,"Rockingham County, NH",172874
"2864","2020","M08","August",12642,188924,0.0669157968283543,2020-08-01,"Rockingham County, NH",176282
"2865","2020","M09","September",10658,185613,0.0574205470522,2020-09-01,"Rockingham County, NH",174955
"2866","2020","M10","October",8126,184061,0.0441484073214858,2020-10-01,"Rockingham County, NH",175935
"2867","2020","M11","November",7523,184242,0.0408321663898568,2020-11-01,"Rockingham County, NH",176719
"2868","2020","M12","December",6841,184186,0.0371418023085359,2020-12-01,"Rockingham County, NH",177345
"2869","2021","M01","January",7352,183579,0.0400481536559193,2021-01-01,"Rockingham County, NH",176227
"2870","2021","M02","February",5693,181554,0.0313570618108111,2021-02-01,"Rockingham County, NH",175861
"2871","2021","M03","March",5679,181653,0.031262902346782,2021-03-01,"Rockingham County, NH",175974
"2872","2021","M04","April",4655,181317,0.025673268364246,2021-04-01,"Rockingham County, NH",176662
"2873","2021","M05","May",4096,181679,0.0225452583953016,2021-05-01,"Rockingham County, NH",177583
"2874","2021","M06","June",5521,184653,0.0298993246792633,2021-06-01,"Rockingham County, NH",179132
"2875","2021","M07","July",6268,187799,0.0333761095639487,2021-07-01,"Rockingham County, NH",181531
"2876","2021","M08","August",5344,187617,0.0284835595921478,2021-08-01,"Rockingham County, NH",182273
"2877","2021","M09","September",4344,181717,0.0239053033012872,2021-09-01,"Rockingham County, NH",177373
"2878","2021","M10","October",4013,180067,0.0222861490445223,2021-10-01,"Rockingham County, NH",176054
"2879","2021","M11","November",3947,181251,0.0217764315783085,2021-11-01,"Rockingham County, NH",177304
"2880","2021","M12","December",4096,182058,0.0224983247097079,2021-12-01,"Rockingham County, NH",177962
"2881","2020","M01","January",5268,188055,0.0280130812794129,2020-01-01,"Rutherford County, TN",182787
"2882","2020","M02","February",5272,188561,0.027959121981746,2020-02-01,"Rutherford County, TN",183289
"2883","2020","M03","March",5922,186253,0.0317954610127085,2020-03-01,"Rutherford County, TN",180331
"2884","2020","M04","April",30803,179865,0.171256219942735,2020-04-01,"Rutherford County, TN",149062
"2885","2020","M05","May",19724,178079,0.110759831310823,2020-05-01,"Rutherford County, TN",158355
"2886","2020","M06","June",18286,179180,0.102053800647394,2020-06-01,"Rutherford County, TN",160894
"2887","2020","M07","July",15050,177238,0.0849140703460883,2020-07-01,"Rutherford County, TN",162188
"2888","2020","M08","August",12605,187408,0.0672596687441305,2020-08-01,"Rutherford County, TN",174803
"2889","2020","M09","September",12181,188002,0.0647918639163413,2020-09-01,"Rutherford County, TN",175821
"2890","2020","M10","October",11030,188478,0.0585214189454472,2020-10-01,"Rutherford County, TN",177448
"2891","2020","M11","November",7414,185435,0.0399816647342735,2020-11-01,"Rutherford County, TN",178021
"2892","2020","M12","December",8093,185866,0.0435421217436218,2020-12-01,"Rutherford County, TN",177773
"2893","2021","M01","January",7689,185473,0.0414561688224162,2021-01-01,"Rutherford County, TN",177784
"2894","2021","M02","February",7250,185529,0.0390774488085421,2021-02-01,"Rutherford County, TN",178279
"2895","2021","M03","March",7693,185581,0.0414535970815978,2021-03-01,"Rutherford County, TN",177888
"2896","2021","M04","April",7147,186988,0.0382217040665711,2021-04-01,"Rutherford County, TN",179841
"2897","2021","M05","May",6885,187613,0.0366978834089322,2021-05-01,"Rutherford County, TN",180728
"2898","2021","M06","June",8436,187725,0.044938074310827,2021-06-01,"Rutherford County, TN",179289
"2899","2021","M07","July",6899,188587,0.036582585225917,2021-07-01,"Rutherford County, TN",181688
"2900","2021","M08","August",6424,186908,0.0343698504076872,2021-08-01,"Rutherford County, TN",180484
"2901","2021","M09","September",5327,185678,0.0286894516313187,2021-09-01,"Rutherford County, TN",180351
"2902","2021","M10","October",4966,186522,0.0266242051875918,2021-10-01,"Rutherford County, TN",181556
"2903","2021","M11","November",4631,188837,0.0245237956544533,2021-11-01,"Rutherford County, TN",184206
"2904","2021","M12","December",4954,191335,0.0258917605247341,2021-12-01,"Rutherford County, TN",186381
"2905","2020","M01","January",38631,978079,0.0394968095624178,2020-01-01,"San Bernardino County, CA",939448
"2906","2020","M02","February",36616,980397,0.0373481355002106,2020-02-01,"San Bernardino County, CA",943781
"2907","2020","M03","March",43123,975656,0.0441989799683495,2020-03-01,"San Bernardino County, CA",932533
"2908","2020","M04","April",132840,935015,0.142072587070796,2020-04-01,"San Bernardino County, CA",802175
"2909","2020","M05","May",131912,937211,0.140749521719229,2020-05-01,"San Bernardino County, CA",805299
"2910","2020","M06","June",125069,965348,0.129558459747159,2020-06-01,"San Bernardino County, CA",840279
"2911","2020","M07","July",122252,964009,0.126816243416815,2020-07-01,"San Bernardino County, CA",841757
"2912","2020","M08","August",108769,960651,0.113224261464361,2020-08-01,"San Bernardino County, CA",851882
"2913","2020","M09","September",100513,959915,0.104710312892287,2020-09-01,"San Bernardino County, CA",859402
"2914","2020","M10","October",92867,984411,0.0943376293032077,2020-10-01,"San Bernardino County, CA",891544
"2915","2020","M11","November",76379,972556,0.0785342951973974,2020-11-01,"San Bernardino County, CA",896177
"2916","2020","M12","December",86569,981220,0.0882258820651842,2020-12-01,"San Bernardino County, CA",894651
"2917","2021","M01","January",83391,969831,0.085985083999171,2021-01-01,"San Bernardino County, CA",886440
"2918","2021","M02","February",79840,984845,0.0810685945504115,2021-02-01,"San Bernardino County, CA",905005
"2919","2021","M03","March",75668,976755,0.0774687613577612,2021-03-01,"San Bernardino County, CA",901087
"2920","2021","M04","April",73430,964565,0.0761275808265902,2021-04-01,"San Bernardino County, CA",891135
"2921","2021","M05","May",70321,970246,0.0724774953980743,2021-05-01,"San Bernardino County, CA",899925
"2922","2021","M06","June",79044,978588,0.0807735226673534,2021-06-01,"San Bernardino County, CA",899544
"2923","2021","M07","July",78302,985341,0.0794669053657566,2021-07-01,"San Bernardino County, CA",907039
"2924","2021","M08","August",74551,977447,0.0762711430901113,2021-08-01,"San Bernardino County, CA",902896
"2925","2021","M09","September",64930,980500,0.0662213156552779,2021-09-01,"San Bernardino County, CA",915570
"2926","2021","M10","October",62621,988056,0.0633779866728202,2021-10-01,"San Bernardino County, CA",925435
"2927","2021","M11","November",54348,992605,0.0547528976783313,2021-11-01,"San Bernardino County, CA",938257
"2928","2021","M12","December",51291,992138,0.0516974453150671,2021-12-01,"San Bernardino County, CA",940847
"2929","2020","M01","January",53959,1577148,0.0342130224937672,2020-01-01,"San Diego County, CA",1523189
"2930","2020","M02","February",50564,1585590,0.031889706670703,2020-02-01,"San Diego County, CA",1535026
"2931","2020","M03","March",59209,1573622,0.0376259355804634,2020-03-01,"San Diego County, CA",1514413
"2932","2020","M04","April",240383,1512665,0.158913573064757,2020-04-01,"San Diego County, CA",1272282
"2933","2020","M05","May",234493,1507154,0.155586622203172,2020-05-01,"San Diego County, CA",1272661
"2934","2020","M06","June",206976,1537017,0.134660839795526,2020-06-01,"San Diego County, CA",1330041
"2935","2020","M07","July",189612,1535410,0.123492747865391,2020-07-01,"San Diego County, CA",1345798
"2936","2020","M08","August",164732,1518659,0.108472013796382,2020-08-01,"San Diego County, CA",1353927
"2937","2020","M09","September",145203,1512118,0.0960262360477158,2020-09-01,"San Diego County, CA",1366915
"2938","2020","M10","October",129646,1541792,0.0840878665864137,2020-10-01,"San Diego County, CA",1412146
"2939","2020","M11","November",104336,1523998,0.0684620321024043,2020-11-01,"San Diego County, CA",1419662
"2940","2020","M12","December",122650,1535149,0.0798945248962804,2020-12-01,"San Diego County, CA",1412499
"2941","2021","M01","January",121725,1518715,0.0801499952262274,2021-01-01,"San Diego County, CA",1396990
"2942","2021","M02","February",111442,1548520,0.071966781184615,2021-02-01,"San Diego County, CA",1437078
"2943","2021","M03","March",104363,1533968,0.0680346656514347,2021-03-01,"San Diego County, CA",1429605
"2944","2021","M04","April",101018,1515125,0.0666730467783186,2021-04-01,"San Diego County, CA",1414107
"2945","2021","M05","May",96178,1519679,0.0632883655035044,2021-05-01,"San Diego County, CA",1423501
"2946","2021","M06","June",107387,1527783,0.0702894324652127,2021-06-01,"San Diego County, CA",1420396
"2947","2021","M07","July",106336,1545350,0.068810301873362,2021-07-01,"San Diego County, CA",1439014
"2948","2021","M08","August",101620,1536342,0.066144126763442,2021-08-01,"San Diego County, CA",1434722
"2949","2021","M09","September",86162,1537820,0.0560286639528683,2021-09-01,"San Diego County, CA",1451658
"2950","2021","M10","October",82841,1555083,0.0532711115741089,2021-10-01,"San Diego County, CA",1472242
"2951","2021","M11","November",71137,1561369,0.0455606586271407,2021-11-01,"San Diego County, CA",1490232
"2952","2021","M12","December",65751,1554504,0.0422970928347563,2021-12-01,"San Diego County, CA",1488753
"2953","2020","M01","January",23302,714797,0.0325994653027363,2020-01-01,"San Diego, CA",691495
"2954","2020","M02","February",21921,718789,0.0304971278080215,2020-02-01,"San Diego, CA",696868
"2955","2020","M03","March",25798,713309,0.0361666542830667,2020-03-01,"San Diego, CA",687511
"2956","2020","M04","April",106453,684041,0.155623712613718,2020-04-01,"San Diego, CA",577588
"2957","2020","M05","May",103632,681392,0.152088665555216,2020-05-01,"San Diego, CA",577760
"2958","2020","M06","June",92211,696021,0.132483071631459,2020-06-01,"San Diego, CA",603810
"2959","2020","M07","July",83994,694957,0.12086215406133,2020-07-01,"San Diego, CA",610963
"2960","2020","M08","August",72963,687616,0.106110096332837,2020-08-01,"San Diego, CA",614653
"2961","2020","M09","September",64164,684714,0.0937091982930099,2020-09-01,"San Diego, CA",620550
"2962","2020","M10","October",56214,697298,0.0806168955023534,2020-10-01,"San Diego, CA",641084
"2963","2020","M11","November",45130,689626,0.0654412681656434,2020-11-01,"San Diego, CA",644496
"2964","2020","M12","December",54900,696144,0.0788629938633386,2020-12-01,"San Diego, CA",641244
"2965","2021","M01","January",54806,689009,0.0795432280275004,2021-01-01,"San Diego, CA",634203
"2966","2021","M02","February",48501,700903,0.0691978775950453,2021-02-01,"San Diego, CA",652402
"2967","2021","M03","March",45046,694056,0.0649025438869486,2021-03-01,"San Diego, CA",649010
"2968","2021","M04","April",44229,686203,0.0644546876070201,2021-04-01,"San Diego, CA",641974
"2969","2021","M05","May",41910,688148,0.0609025965344664,2021-05-01,"San Diego, CA",646238
"2970","2021","M06","June",46865,691694,0.0677539490005696,2021-06-01,"San Diego, CA",644829
"2971","2021","M07","July",45883,699164,0.0656255184763518,2021-07-01,"San Diego, CA",653281
"2972","2021","M08","August",43917,695250,0.0631672060409924,2021-08-01,"San Diego, CA",651333
"2973","2021","M09","September",37108,696129,0.0533062119233648,2021-09-01,"San Diego, CA",659021
"2974","2021","M10","October",35442,703808,0.0503574838592343,2021-10-01,"San Diego, CA",668366
"2975","2021","M11","November",30410,706943,0.0430161979112885,2021-11-01,"San Diego, CA",676533
"2976","2021","M12","December",28385,704246,0.0403055182422051,2021-12-01,"San Diego, CA",675861
"2977","2020","M01","January",13723,580748,0.023629870442946,2020-01-01,"San Francisco, CA",567025
"2978","2020","M02","February",13113,583926,0.0224566126529732,2020-02-01,"San Francisco, CA",570813
"2979","2020","M03","March",16118,579164,0.027829768424833,2020-03-01,"San Francisco, CA",563046
"2980","2020","M04","April",71749,550493,0.130335898912429,2020-04-01,"San Francisco, CA",478744
"2981","2020","M05","May",70072,548897,0.127659651992997,2020-05-01,"San Francisco, CA",478825
"2982","2020","M06","June",66669,554992,0.120126055871076,2020-06-01,"San Francisco, CA",488323
"2983","2020","M07","July",60917,553239,0.110109735575402,2020-07-01,"San Francisco, CA",492322
"2984","2020","M08","August",52888,546571,0.096763275036546,2020-08-01,"San Francisco, CA",493683
"2985","2020","M09","September",48491,541684,0.0895189815464367,2020-09-01,"San Francisco, CA",493193
"2986","2020","M10","October",41598,550262,0.0755967157463172,2020-10-01,"San Francisco, CA",508664
"2987","2020","M11","November",32032,541049,0.0592035102181133,2020-11-01,"San Francisco, CA",509017
"2988","2020","M12","December",34929,541641,0.0644873634012196,2020-12-01,"San Francisco, CA",506712
"2989","2021","M01","January",33217,536339,0.0619328447120198,2021-01-01,"San Francisco, CA",503122
"2990","2021","M02","February",30847,543644,0.0567411762109027,2021-02-01,"San Francisco, CA",512797
"2991","2021","M03","March",29151,542439,0.0537406049343797,2021-03-01,"San Francisco, CA",513288
"2992","2021","M04","April",28847,539815,0.0534386780656336,2021-04-01,"San Francisco, CA",510968
"2993","2021","M05","May",27567,544241,0.0506521926866958,2021-05-01,"San Francisco, CA",516674
"2994","2021","M06","June",30454,550632,0.0553073559110259,2021-06-01,"San Francisco, CA",520178
"2995","2021","M07","July",29420,561225,0.052421043253597,2021-07-01,"San Francisco, CA",531805
"2996","2021","M08","August",27922,557305,0.0501018293394102,2021-08-01,"San Francisco, CA",529383
"2997","2021","M09","September",23123,559083,0.041358796457771,2021-09-01,"San Francisco, CA",535960
"2998","2021","M10","October",21848,562308,0.0388541511057997,2021-10-01,"San Francisco, CA",540460
"2999","2021","M11","November",18762,565532,0.0331758415085265,2021-11-01,"San Francisco, CA",546770
"3000","2021","M12","December",17206,566632,0.030365387058973,2021-12-01,"San Francisco, CA",549426
"3001","2020","M01","January",22283,329406,0.067646005233663,2020-01-01,"San Joaquin County, CA",307123
"3002","2020","M02","February",21422,330931,0.0647325273244271,2020-02-01,"San Joaquin County, CA",309509
"3003","2020","M03","March",24736,330476,0.074849610864329,2020-03-01,"San Joaquin County, CA",305740
"3004","2020","M04","April",58835,329544,0.178534581118151,2020-04-01,"San Joaquin County, CA",270709
"3005","2020","M05","May",52894,334828,0.157973646170571,2020-05-01,"San Joaquin County, CA",281934
"3006","2020","M06","June",48519,333887,0.145315630737345,2020-06-01,"San Joaquin County, CA",285368
"3007","2020","M07","July",45902,331605,0.138423727024623,2020-07-01,"San Joaquin County, CA",285703
"3008","2020","M08","August",40402,331302,0.121949158169887,2020-08-01,"San Joaquin County, CA",290900
"3009","2020","M09","September",37380,330993,0.11293290190427,2020-09-01,"San Joaquin County, CA",293613
"3010","2020","M10","October",34080,335549,0.101564898122182,2020-10-01,"San Joaquin County, CA",301469
"3011","2020","M11","November",28660,330682,0.0866693681542993,2020-11-01,"San Joaquin County, CA",302022
"3012","2020","M12","December",33377,332738,0.100310153934928,2020-12-01,"San Joaquin County, CA",299361
"3013","2021","M01","January",32980,329776,0.100007277667265,2021-01-01,"San Joaquin County, CA",296796
"3014","2021","M02","February",31880,334185,0.0953962625491868,2021-02-01,"San Joaquin County, CA",302305
"3015","2021","M03","March",30414,333389,0.0912267651302233,2021-03-01,"San Joaquin County, CA",302975
"3016","2021","M04","April",29154,328164,0.0888397264782243,2021-04-01,"San Joaquin County, CA",299010
"3017","2021","M05","May",27585,333858,0.0826249483313265,2021-05-01,"San Joaquin County, CA",306273
"3018","2021","M06","June",30498,332564,0.091705656655561,2021-06-01,"San Joaquin County, CA",302066
"3019","2021","M07","July",29999,332429,0.0902418260741391,2021-07-01,"San Joaquin County, CA",302430
"3020","2021","M08","August",28384,334168,0.084939311962845,2021-08-01,"San Joaquin County, CA",305784
"3021","2021","M09","September",24898,333570,0.0746410048865306,2021-09-01,"San Joaquin County, CA",308672
"3022","2021","M10","October",24195,332305,0.0728096176705135,2021-10-01,"San Joaquin County, CA",308110
"3023","2021","M11","November",21740,329866,0.0659055495261712,2021-11-01,"San Joaquin County, CA",308126
"3024","2021","M12","December",21259,329603,0.0644988061395072,2021-12-01,"San Joaquin County, CA",308344
"3025","2020","M01","January",15601,551971,0.028264166052202,2020-01-01,"San Jose, CA",536370
"3026","2020","M02","February",14906,554624,0.0268758654511886,2020-02-01,"San Jose, CA",539718
"3027","2020","M03","March",17512,550160,0.0318307401483205,2020-03-01,"San Jose, CA",532648
"3028","2020","M04","April",77462,541756,0.142983188003455,2020-04-01,"San Jose, CA",464294
"3029","2020","M05","May",71589,540076,0.13255356653508,2020-05-01,"San Jose, CA",468487
"3030","2020","M06","June",65342,544248,0.12005923770046,2020-06-01,"San Jose, CA",478906
"3031","2020","M07","July",58865,543127,0.108381649227529,2020-07-01,"San Jose, CA",484262
"3032","2020","M08","August",51216,537721,0.0952464196116573,2020-08-01,"San Jose, CA",486505
"3033","2020","M09","September",46104,532136,0.0866395056902747,2020-09-01,"San Jose, CA",486032
"3034","2020","M10","October",39636,540082,0.0733888557663466,2020-10-01,"San Jose, CA",500446
"3035","2020","M11","November",31374,533748,0.0587805481238337,2020-11-01,"San Jose, CA",502374
"3036","2020","M12","December",35661,534723,0.066690604294186,2020-12-01,"San Jose, CA",499062
"3037","2021","M01","January",33878,530886,0.0638140768451231,2021-01-01,"San Jose, CA",497008
"3038","2021","M02","February",31789,538297,0.0590547597330098,2021-02-01,"San Jose, CA",506508
"3039","2021","M03","March",29617,533511,0.0555133821045864,2021-03-01,"San Jose, CA",503894
"3040","2021","M04","April",28966,529389,0.0547159083396142,2021-04-01,"San Jose, CA",500423
"3041","2021","M05","May",27954,532425,0.0525031694604874,2021-05-01,"San Jose, CA",504471
"3042","2021","M06","June",31189,535931,0.0581959244753522,2021-06-01,"San Jose, CA",504742
"3043","2021","M07","July",30124,543149,0.0554617609532559,2021-07-01,"San Jose, CA",513025
"3044","2021","M08","August",28677,540681,0.0530386679021456,2021-08-01,"San Jose, CA",512004
"3045","2021","M09","September",23817,541777,0.0439608916583761,2021-09-01,"San Jose, CA",517960
"3046","2021","M10","October",22608,545551,0.041440671907851,2021-10-01,"San Jose, CA",522943
"3047","2021","M11","November",19239,547704,0.0351266377459358,2021-11-01,"San Jose, CA",528465
"3048","2021","M12","December",17544,549109,0.0319499407221517,2021-12-01,"San Jose, CA",531565
"3049","2020","M01","January",4724,157251,0.0300411444124362,2020-01-01,"Santa Ana, CA",152527
"3050","2020","M02","February",4487,158022,0.0283947804736049,2020-02-01,"Santa Ana, CA",153535
"3051","2020","M03","March",5193,156155,0.0332554192949313,2020-03-01,"Santa Ana, CA",150962
"3052","2020","M04","April",21958,149487,0.146889027139484,2020-04-01,"Santa Ana, CA",127529
"3053","2020","M05","May",22451,148599,0.151084462210378,2020-05-01,"Santa Ana, CA",126148
"3054","2020","M06","June",20285,151338,0.134037716898598,2020-06-01,"Santa Ana, CA",131053
"3055","2020","M07","July",19040,151282,0.125857669782261,2020-07-01,"Santa Ana, CA",132242
"3056","2020","M08","August",16665,149695,0.111326363605999,2020-08-01,"Santa Ana, CA",133030
"3057","2020","M09","September",14913,149248,0.0999209369639794,2020-09-01,"Santa Ana, CA",134335
"3058","2020","M10","October",13515,152918,0.0883807007677317,2020-10-01,"Santa Ana, CA",139403
"3059","2020","M11","November",10909,151034,0.072228769680999,2020-11-01,"Santa Ana, CA",140125
"3060","2020","M12","December",12268,151708,0.0808658739156801,2020-12-01,"Santa Ana, CA",139440
"3061","2021","M01","January",11705,149320,0.0783886954192339,2021-01-01,"Santa Ana, CA",137615
"3062","2021","M02","February",10966,151721,0.0722774039190356,2021-02-01,"Santa Ana, CA",140755
"3063","2021","M03","March",10389,151539,0.0685566091897135,2021-03-01,"Santa Ana, CA",141150
"3064","2021","M04","April",9670,150506,0.0642499302353395,2021-04-01,"Santa Ana, CA",140836
"3065","2021","M05","May",9048,152034,0.0595130036702317,2021-05-01,"Santa Ana, CA",142986
"3066","2021","M06","June",10082,153220,0.0658008092938259,2021-06-01,"Santa Ana, CA",143138
"3067","2021","M07","July",9948,155507,0.0639713967859968,2021-07-01,"Santa Ana, CA",145559
"3068","2021","M08","August",9174,154008,0.0595683341125136,2021-08-01,"Santa Ana, CA",144834
"3069","2021","M09","September",7826,154605,0.0506193202030982,2021-09-01,"Santa Ana, CA",146779
"3070","2021","M10","October",7565,155373,0.0486892832087943,2021-10-01,"Santa Ana, CA",147808
"3071","2021","M11","November",6445,155528,0.0414394835656602,2021-11-01,"Santa Ana, CA",149083
"3072","2021","M12","December",6040,155669,0.0388002749423456,2021-12-01,"Santa Ana, CA",149629
"3073","2020","M01","January",10194,219246,0.0464957171396514,2020-01-01,"Santa Barbara County, CA",209052
"3074","2020","M02","February",9754,221977,0.04394148943359,2020-02-01,"Santa Barbara County, CA",212223
"3075","2020","M03","March",10979,222676,0.0493048195584616,2020-03-01,"Santa Barbara County, CA",211697
"3076","2020","M04","April",29940,214288,0.13971850966923,2020-04-01,"Santa Barbara County, CA",184348
"3077","2020","M05","May",26715,215578,0.123922663722643,2020-05-01,"Santa Barbara County, CA",188863
"3078","2020","M06","June",23174,216810,0.106886213735529,2020-06-01,"Santa Barbara County, CA",193636
"3079","2020","M07","July",20996,219400,0.095697356426618,2020-07-01,"Santa Barbara County, CA",198404
"3080","2020","M08","August",17888,216272,0.0827106606495524,2020-08-01,"Santa Barbara County, CA",198384
"3081","2020","M09","September",16110,215658,0.0747016108838995,2020-09-01,"Santa Barbara County, CA",199548
"3082","2020","M10","October",14498,219314,0.0661061309355536,2020-10-01,"Santa Barbara County, CA",204816
"3083","2020","M11","November",12292,215776,0.0569664837609373,2020-11-01,"Santa Barbara County, CA",203484
"3084","2020","M12","December",15484,213126,0.072651858525004,2020-12-01,"Santa Barbara County, CA",197642
"3085","2021","M01","January",16362,210930,0.0775707580713981,2021-01-01,"Santa Barbara County, CA",194568
"3086","2021","M02","February",15332,213584,0.0717844033260918,2021-02-01,"Santa Barbara County, CA",198252
"3087","2021","M03","March",14096,214439,0.0657343113892529,2021-03-01,"Santa Barbara County, CA",200343
"3088","2021","M04","April",12807,216210,0.0592340779797419,2021-04-01,"Santa Barbara County, CA",203403
"3089","2021","M05","May",11758,219421,0.0535864844294758,2021-05-01,"Santa Barbara County, CA",207663
"3090","2021","M06","June",13133,221634,0.059255348908561,2021-06-01,"Santa Barbara County, CA",208501
"3091","2021","M07","July",12749,221925,0.0574473358116481,2021-07-01,"Santa Barbara County, CA",209176
"3092","2021","M08","August",12044,220673,0.0545784939707169,2021-08-01,"Santa Barbara County, CA",208629
"3093","2021","M09","September",10128,221486,0.0457274951915697,2021-09-01,"Santa Barbara County, CA",211358
"3094","2021","M10","October",9812,221184,0.044361255787037,2021-10-01,"Santa Barbara County, CA",211372
"3095","2021","M11","November",8629,220565,0.0391222542107769,2021-11-01,"Santa Barbara County, CA",211936
"3096","2021","M12","December",8588,216630,0.0396436319992614,2021-12-01,"Santa Barbara County, CA",208042
"3097","2020","M01","January",11097,482443,0.0230016810276033,2020-01-01,"Seattle, WA",471346
"3098","2020","M02","February",10785,487684,0.0221147300301015,2020-02-01,"Seattle, WA",476899
"3099","2020","M03","March",23973,475168,0.0504516297393764,2020-03-01,"Seattle, WA",451195
"3100","2020","M04","April",62854,457791,0.137298461525019,2020-04-01,"Seattle, WA",394937
"3101","2020","M05","May",52082,466163,0.111724868769079,2020-05-01,"Seattle, WA",414081
"3102","2020","M06","June",47008,472529,0.0994817249311682,2020-06-01,"Seattle, WA",425521
"3103","2020","M07","July",42334,475067,0.089111641094835,2020-07-01,"Seattle, WA",432733
"3104","2020","M08","August",35278,477265,0.0739170062753397,2020-08-01,"Seattle, WA",441987
"3105","2020","M09","September",32645,476996,0.0684387290459459,2020-09-01,"Seattle, WA",444351
"3106","2020","M10","October",26716,473905,0.0563741678184446,2020-10-01,"Seattle, WA",447189
"3107","2020","M11","November",24924,476954,0.0522566117487221,2020-11-01,"Seattle, WA",452030
"3108","2020","M12","December",24673,473538,0.0521035270664656,2020-12-01,"Seattle, WA",448865
"3109","2021","M01","January",26635,478237,0.0556941432804237,2021-01-01,"Seattle, WA",451602
"3110","2021","M02","February",22846,484899,0.047114966209458,2021-02-01,"Seattle, WA",462053
"3111","2021","M03","March",23546,483022,0.0487472620294728,2021-03-01,"Seattle, WA",459476
"3112","2021","M04","April",20763,481206,0.0431478410493635,2021-04-01,"Seattle, WA",460443
"3113","2021","M05","May",18934,476926,0.0397000792575787,2021-05-01,"Seattle, WA",457992
"3114","2021","M06","June",21081,478052,0.0440977132194824,2021-06-01,"Seattle, WA",456971
"3115","2021","M07","July",21210,485021,0.0437300652961418,2021-07-01,"Seattle, WA",463811
"3116","2021","M08","August",20206,486110,0.0415667235810825,2021-08-01,"Seattle, WA",465904
"3117","2021","M09","September",18414,483210,0.0381076550568076,2021-09-01,"Seattle, WA",464796
"3118","2021","M10","October",18308,479094,0.0382137952051163,2021-10-01,"Seattle, WA",460786
"3119","2021","M11","November",12014,476077,0.0252354135990607,2021-11-01,"Seattle, WA",464063
"3120","2021","M12","December",12819,485328,0.026413064978736,2021-12-01,"Seattle, WA",472509
"3121","2020","M01","January",8586,256173,0.0335164127367053,2020-01-01,"Seminole County, FL",247587
"3122","2020","M02","February",7666,257657,0.0297527332849486,2020-02-01,"Seminole County, FL",249991
"3123","2020","M03","March",12674,260066,0.0487337829627864,2020-03-01,"Seminole County, FL",247392
"3124","2020","M04","April",31915,234421,0.136143946148169,2020-04-01,"Seminole County, FL",202506
"3125","2020","M05","May",33015,227808,0.144924673409187,2020-05-01,"Seminole County, FL",194793
"3126","2020","M06","June",26382,227334,0.116049513051281,2020-06-01,"Seminole County, FL",200952
"3127","2020","M07","July",25428,234498,0.108435892843436,2020-07-01,"Seminole County, FL",209070
"3128","2020","M08","August",16992,231409,0.0734284319105998,2020-08-01,"Seminole County, FL",214417
"3129","2020","M09","September",14265,232939,0.0612392085481607,2020-09-01,"Seminole County, FL",218674
"3130","2020","M10","October",11423,232061,0.0492241264150374,2020-10-01,"Seminole County, FL",220638
"3131","2020","M11","November",9809,230444,0.0425656558643315,2020-11-01,"Seminole County, FL",220635
"3132","2020","M12","December",7849,228421,0.0343619894843294,2020-12-01,"Seminole County, FL",220572
"3133","2021","M01","January",10839,230338,0.0470569337234846,2021-01-01,"Seminole County, FL",219499
"3134","2021","M02","February",10242,232870,0.0439816206467128,2021-02-01,"Seminole County, FL",222628
"3135","2021","M03","March",10937,235575,0.0464268279741059,2021-03-01,"Seminole County, FL",224638
"3136","2021","M04","April",11251,238385,0.0471967615412044,2021-04-01,"Seminole County, FL",227134
"3137","2021","M05","May",10862,242035,0.04487780692875,2021-05-01,"Seminole County, FL",231173
"3138","2021","M06","June",12696,247396,0.0513185338485667,2021-06-01,"Seminole County, FL",234700
"3139","2021","M07","July",11331,249880,0.0453457659676645,2021-07-01,"Seminole County, FL",238549
"3140","2021","M08","August",10757,250321,0.0429728228954023,2021-08-01,"Seminole County, FL",239564
"3141","2021","M09","September",9525,251449,0.0378804449411213,2021-09-01,"Seminole County, FL",241924
"3142","2021","M10","October",9468,252608,0.0374809982265011,2021-10-01,"Seminole County, FL",243140
"3143","2021","M11","November",8600,251907,0.0341395832589011,2021-11-01,"Seminole County, FL",243307
"3144","2021","M12","December",8174,251195,0.032540456617369,2021-12-01,"Seminole County, FL",243021
"3145","2020","M01","January",4157,63235,0.0657389104135368,2020-01-01,"Skagit County, WA",59078
"3146","2020","M02","February",3914,63511,0.061627119711546,2020-02-01,"Skagit County, WA",59597
"3147","2020","M03","March",3879,62929,0.0616408968837897,2020-03-01,"Skagit County, WA",59050
"3148","2020","M04","April",12871,65769,0.195700101871702,2020-04-01,"Skagit County, WA",52898
"3149","2020","M05","May",9053,62508,0.144829461828886,2020-05-01,"Skagit County, WA",53455
"3150","2020","M06","June",7515,62092,0.121030084390904,2020-06-01,"Skagit County, WA",54577
"3151","2020","M07","July",7894,63234,0.124837903659424,2020-07-01,"Skagit County, WA",55340
"3152","2020","M08","August",5981,61803,0.0967752374480203,2020-08-01,"Skagit County, WA",55822
"3153","2020","M09","September",5015,60863,0.0823981729457963,2020-09-01,"Skagit County, WA",55848
"3154","2020","M10","October",4223,63935,0.0660514585125518,2020-10-01,"Skagit County, WA",59712
"3155","2020","M11","November",4431,60255,0.0735374657704755,2020-11-01,"Skagit County, WA",55824
"3156","2020","M12","December",4551,59838,0.0760553494434974,2020-12-01,"Skagit County, WA",55287
"3157","2021","M01","January",4387,59501,0.0737298532797768,2021-01-01,"Skagit County, WA",55114
"3158","2021","M02","February",4512,59463,0.0758791181070582,2021-02-01,"Skagit County, WA",54951
"3159","2021","M03","March",4390,60926,0.072054623641795,2021-03-01,"Skagit County, WA",56536
"3160","2021","M04","April",3967,61414,0.0645943921581398,2021-04-01,"Skagit County, WA",57447
"3161","2021","M05","May",3345,62024,0.053930736489101,2021-05-01,"Skagit County, WA",58679
"3162","2021","M06","June",3410,62564,0.0545041877117831,2021-06-01,"Skagit County, WA",59154
"3163","2021","M07","July",3164,63170,0.0500870666455596,2021-07-01,"Skagit County, WA",60006
"3164","2021","M08","August",3298,63175,0.0522041946972695,2021-08-01,"Skagit County, WA",59877
"3165","2021","M09","September",2768,62201,0.044500892268613,2021-09-01,"Skagit County, WA",59433
"3166","2021","M10","October",2852,62446,0.0456714601415623,2021-10-01,"Skagit County, WA",59594
"3167","2021","M11","November",2686,63051,0.0426004345688411,2021-11-01,"Skagit County, WA",60365
"3168","2021","M12","December",2744,63042,0.0435265378636465,2021-12-01,"Skagit County, WA",60298
"3169","2020","M01","January",13125,443970,0.029562808297858,2020-01-01,"Snohomish County, WA",430845
"3170","2020","M02","February",12541,448607,0.0279554264645893,2020-02-01,"Snohomish County, WA",436066
"3171","2020","M03","March",23149,435884,0.0531081663928935,2020-03-01,"Snohomish County, WA",412735
"3172","2020","M04","April",86170,447496,0.192560380427981,2020-04-01,"Snohomish County, WA",361326
"3173","2020","M05","May",60178,438896,0.137112208814845,2020-05-01,"Snohomish County, WA",378718
"3174","2020","M06","June",49210,438434,0.112240382817026,2020-06-01,"Snohomish County, WA",389224
"3175","2020","M07","July",43138,438920,0.0982821470883077,2020-07-01,"Snohomish County, WA",395782
"3176","2020","M08","August",36714,441049,0.0832424515189922,2020-08-01,"Snohomish County, WA",404335
"3177","2020","M09","September",34390,440665,0.0780411423643811,2020-09-01,"Snohomish County, WA",406275
"3178","2020","M10","October",30521,438762,0.069561630223219,2020-10-01,"Snohomish County, WA",408241
"3179","2020","M11","November",29163,441973,0.0659836686856437,2020-11-01,"Snohomish County, WA",412810
"3180","2020","M12","December",29214,439210,0.0665148789872726,2020-12-01,"Snohomish County, WA",409996
"3181","2021","M01","January",32777,445431,0.0735849098962578,2021-01-01,"Snohomish County, WA",412654
"3182","2021","M02","February",28090,450675,0.0623287291285294,2021-02-01,"Snohomish County, WA",422585
"3183","2021","M03","March",28604,448903,0.0637197791059538,2021-03-01,"Snohomish County, WA",420299
"3184","2021","M04","April",24919,446071,0.0558633042721899,2021-04-01,"Snohomish County, WA",421152
"3185","2021","M05","May",23321,442047,0.0527568335493737,2021-05-01,"Snohomish County, WA",418726
"3186","2021","M06","June",26442,444292,0.0595149136153701,2021-06-01,"Snohomish County, WA",417850
"3187","2021","M07","July",26788,450952,0.05940321808086,2021-07-01,"Snohomish County, WA",424164
"3188","2021","M08","August",25120,451339,0.055656612878568,2021-08-01,"Snohomish County, WA",426219
"3189","2021","M09","September",23536,448365,0.0524929465948502,2021-09-01,"Snohomish County, WA",424829
"3190","2021","M10","October",23200,444486,0.0521951197563028,2021-10-01,"Snohomish County, WA",421286
"3191","2021","M11","November",15912,440005,0.036163225417893,2021-11-01,"Snohomish County, WA",424093
"3192","2021","M12","December",17075,448508,0.0380706698654205,2021-12-01,"Snohomish County, WA",431433
"3193","2020","M01","January",6360,151721,0.041919048780327,2020-01-01,"St Louis, MO",145361
"3194","2020","M02","February",6271,152634,0.0410852103725251,2020-02-01,"St Louis, MO",146363
"3195","2020","M03","March",7807,152691,0.0511294051384823,2020-03-01,"St Louis, MO",144884
"3196","2020","M04","April",21783,147448,0.147733438229071,2020-04-01,"St Louis, MO",125665
"3197","2020","M05","May",19766,145447,0.135898299724298,2020-05-01,"St Louis, MO",125681
"3198","2020","M06","June",18727,152741,0.122606241938969,2020-06-01,"St Louis, MO",134014
"3199","2020","M07","July",17809,159927,0.1113570566571,2020-07-01,"St Louis, MO",142118
"3200","2020","M08","August",15163,156684,0.0967743994281484,2020-08-01,"St Louis, MO",141521
"3201","2020","M09","September",12374,153929,0.0803877112175094,2020-09-01,"St Louis, MO",141555
"3202","2020","M10","October",9693,151526,0.063969219803862,2020-10-01,"St Louis, MO",141833
"3203","2020","M11","November",9563,151413,0.0631583813807269,2020-11-01,"St Louis, MO",141850
"3204","2020","M12","December",10176,151343,0.0672379958108403,2020-12-01,"St Louis, MO",141167
"3205","2021","M01","January",10526,150319,0.0700244147446431,2021-01-01,"St Louis, MO",139793
"3206","2021","M02","February",10664,151544,0.0703690017420683,2021-02-01,"St Louis, MO",140880
"3207","2021","M03","March",9516,151250,0.0629157024793388,2021-03-01,"St Louis, MO",141734
"3208","2021","M04","April",9505,153276,0.062012317649208,2021-04-01,"St Louis, MO",143771
"3209","2021","M05","May",10250,153758,0.0666631980124611,2021-05-01,"St Louis, MO",143508
"3210","2021","M06","June",11415,154406,0.0739284742820875,2021-06-01,"St Louis, MO",142991
"3211","2021","M07","July",9322,154200,0.0604539559014267,2021-07-01,"St Louis, MO",144878
"3212","2021","M08","August",8296,151115,0.0548985871687126,2021-08-01,"St Louis, MO",142819
"3213","2021","M09","September",6070,149265,0.040665929722306,2021-09-01,"St Louis, MO",143195
"3214","2021","M10","October",6208,149476,0.0415317509165351,2021-10-01,"St Louis, MO",143268
"3215","2021","M11","November",5426,148407,0.0365616177134502,2021-11-01,"St Louis, MO",142981
"3216","2021","M12","December",5773,149342,0.0386562387004326,2021-12-01,"St Louis, MO",143569
"3217","2020","M01","January",8013,229768,0.0348743079976324,2020-01-01,"St. Charles County, MO",221755
"3218","2020","M02","February",6712,230140,0.0291648561745025,2020-02-01,"St. Charles County, MO",223428
"3219","2020","M03","March",7825,229086,0.0341574779777027,2020-03-01,"St. Charles County, MO",221261
"3220","2020","M04","April",26001,218595,0.118945996020037,2020-04-01,"St. Charles County, MO",192594
"3221","2020","M05","May",19743,212118,0.0930755522869346,2020-05-01,"St. Charles County, MO",192375
"3222","2020","M06","June",16266,221208,0.0735326027991754,2020-06-01,"St. Charles County, MO",204942
"3223","2020","M07","July",13821,230653,0.059921180301145,2020-07-01,"St. Charles County, MO",216832
"3224","2020","M08","August",10863,226858,0.0478845797811847,2020-08-01,"St. Charles County, MO",215995
"3225","2020","M09","September",8642,224734,0.0384543504765634,2020-09-01,"St. Charles County, MO",216092
"3226","2020","M10","October",7130,223707,0.0318720469185139,2020-10-01,"St. Charles County, MO",216577
"3227","2020","M11","November",7448,223843,0.0332733210330455,2020-11-01,"St. Charles County, MO",216395
"3228","2020","M12","December",8357,223537,0.0373853098144826,2020-12-01,"St. Charles County, MO",215180
"3229","2021","M01","January",8817,222154,0.0396886844261188,2021-01-01,"St. Charles County, MO",213337
"3230","2021","M02","February",8815,223730,0.0394001698475841,2021-02-01,"St. Charles County, MO",214915
"3231","2021","M03","March",7558,223704,0.0337857168401101,2021-03-01,"St. Charles County, MO",216146
"3232","2021","M04","April",6729,226526,0.029705199403159,2021-04-01,"St. Charles County, MO",219797
"3233","2021","M05","May",8117,227277,0.0357141285743828,2021-05-01,"St. Charles County, MO",219160
"3234","2021","M06","June",9294,227843,0.0407912466040212,2021-06-01,"St. Charles County, MO",218549
"3235","2021","M07","July",7256,228481,0.0317575640862916,2021-07-01,"St. Charles County, MO",221225
"3236","2021","M08","August",6352,224239,0.0283269190461962,2021-08-01,"St. Charles County, MO",217887
"3237","2021","M09","September",5606,224185,0.0250061333273859,2021-09-01,"St. Charles County, MO",218579
"3238","2021","M10","October",5222,223640,0.0233500268288321,2021-10-01,"St. Charles County, MO",218418
"3239","2021","M11","November",4528,222297,0.0203691457824442,2021-11-01,"St. Charles County, MO",217769
"3240","2021","M12","December",5667,224270,0.0252686493958175,2021-12-01,"St. Charles County, MO",218603
"3241","2020","M01","January",4189,137298,0.0305102769159055,2020-01-01,"St. Johns County, FL",133109
"3242","2020","M02","February",3686,137645,0.0267790330197247,2020-02-01,"St. Johns County, FL",133959
"3243","2020","M03","March",5999,138716,0.0432466334092679,2020-03-01,"St. Johns County, FL",132717
"3244","2020","M04","April",14656,128034,0.11446959401409,2020-04-01,"St. Johns County, FL",113378
"3245","2020","M05","May",13052,130892,0.0997157962289521,2020-05-01,"St. Johns County, FL",117840
"3246","2020","M06","June",9992,130936,0.0763120914034337,2020-06-01,"St. Johns County, FL",120944
"3247","2020","M07","July",9905,133105,0.0744149355771759,2020-07-01,"St. Johns County, FL",123200
"3248","2020","M08","August",6399,132288,0.0483717343976778,2020-08-01,"St. Johns County, FL",125889
"3249","2020","M09","September",5360,134190,0.0399433638870259,2020-09-01,"St. Johns County, FL",128830
"3250","2020","M10","October",4393,134141,0.03274912219232,2020-10-01,"St. Johns County, FL",129748
"3251","2020","M11","November",3968,134378,0.0295286430814568,2020-11-01,"St. Johns County, FL",130410
"3252","2020","M12","December",3256,134491,0.0242097984251734,2020-12-01,"St. Johns County, FL",131235
"3253","2021","M01","January",4218,134923,0.0312622755201115,2021-01-01,"St. Johns County, FL",130705
"3254","2021","M02","February",4511,136292,0.0330980541777947,2021-02-01,"St. Johns County, FL",131781
"3255","2021","M03","March",4882,137885,0.0354063168582514,2021-03-01,"St. Johns County, FL",133003
"3256","2021","M04","April",4745,138969,0.0341443055645504,2021-04-01,"St. Johns County, FL",134224
"3257","2021","M05","May",4536,140910,0.0321907600596125,2021-05-01,"St. Johns County, FL",136374
"3258","2021","M06","June",5717,143209,0.0399206753765476,2021-06-01,"St. Johns County, FL",137492
"3259","2021","M07","July",5203,143910,0.0361545410325898,2021-07-01,"St. Johns County, FL",138707
"3260","2021","M08","August",4884,143010,0.0341514579400042,2021-08-01,"St. Johns County, FL",138126
"3261","2021","M09","September",4169,142993,0.0291552733350584,2021-09-01,"St. Johns County, FL",138824
"3262","2021","M10","October",4168,143548,0.0290355839161813,2021-10-01,"St. Johns County, FL",139380
"3263","2021","M11","November",3722,143210,0.0259898051812024,2021-11-01,"St. Johns County, FL",139488
"3264","2021","M12","December",3576,143200,0.0249720670391061,2021-12-01,"St. Johns County, FL",139624
"3265","2020","M01","January",6500,148914,0.0436493546610795,2020-01-01,"St. Lucie County, FL",142414
"3266","2020","M02","February",5949,149806,0.0397113600256331,2020-02-01,"St. Lucie County, FL",143857
"3267","2020","M03","March",9853,152618,0.0645598815342882,2020-03-01,"St. Lucie County, FL",142765
"3268","2020","M04","April",20373,139234,0.146322019047072,2020-04-01,"St. Lucie County, FL",118861
"3269","2020","M05","May",19899,144905,0.13732445395259,2020-05-01,"St. Lucie County, FL",125006
"3270","2020","M06","June",15901,143967,0.110448922322477,2020-06-01,"St. Lucie County, FL",128066
"3271","2020","M07","July",16305,146158,0.111557355738311,2020-07-01,"St. Lucie County, FL",129853
"3272","2020","M08","August",11293,143357,0.0787753649978724,2020-08-01,"St. Lucie County, FL",132064
"3273","2020","M09","September",9630,145138,0.0663506455924706,2020-09-01,"St. Lucie County, FL",135508
"3274","2020","M10","October",7735,144153,0.0536582658702906,2020-10-01,"St. Lucie County, FL",136418
"3275","2020","M11","November",6728,142932,0.0470713346206588,2020-11-01,"St. Lucie County, FL",136204
"3276","2020","M12","December",5471,143177,0.0382114445755952,2020-12-01,"St. Lucie County, FL",137706
"3277","2021","M01","January",7488,145511,0.0514600270769907,2021-01-01,"St. Lucie County, FL",138023
"3278","2021","M02","February",7372,147448,0.0499972871792089,2021-02-01,"St. Lucie County, FL",140076
"3279","2021","M03","March",7903,150013,0.05268210088459,2021-03-01,"St. Lucie County, FL",142110
"3280","2021","M04","April",8338,152110,0.0548155939780422,2021-04-01,"St. Lucie County, FL",143772
"3281","2021","M05","May",8156,153660,0.0530782246518287,2021-05-01,"St. Lucie County, FL",145504
"3282","2021","M06","June",9507,155132,0.061283294226852,2021-06-01,"St. Lucie County, FL",145625
"3283","2021","M07","July",8489,155830,0.0544760315728679,2021-07-01,"St. Lucie County, FL",147341
"3284","2021","M08","August",8153,155148,0.0525498233944363,2021-08-01,"St. Lucie County, FL",146995
"3285","2021","M09","September",7038,154070,0.0456805348218342,2021-09-01,"St. Lucie County, FL",147032
"3286","2021","M10","October",6895,154287,0.0446894424027948,2021-10-01,"St. Lucie County, FL",147392
"3287","2021","M11","November",6256,154380,0.0405233838580127,2021-11-01,"St. Lucie County, FL",148124
"3288","2021","M12","December",5966,155377,0.0383969313347535,2021-12-01,"St. Lucie County, FL",149411
"3289","2020","M01","January",36080,1090836,0.0330755493951428,2020-01-01,"Tarrant County, TX",1054756
"3290","2020","M02","February",34852,1097219,0.0317639413827139,2020-02-01,"Tarrant County, TX",1062367
"3291","2020","M03","March",50132,1073764,0.0466880990608737,2020-03-01,"Tarrant County, TX",1023632
"3292","2020","M04","April",134750,1029012,0.130950853828721,2020-04-01,"Tarrant County, TX",894262
"3293","2020","M05","May",125753,1047738,0.120023326442298,2020-05-01,"Tarrant County, TX",921985
"3294","2020","M06","June",111451,1090819,0.102171854358972,2020-06-01,"Tarrant County, TX",979368
"3295","2020","M07","July",99466,1085334,0.0916455211022598,2020-07-01,"Tarrant County, TX",985868
"3296","2020","M08","August",71371,1089791,0.0654905390116086,2020-08-01,"Tarrant County, TX",1018420
"3297","2020","M09","September",80625,1081802,0.0745284257193091,2020-09-01,"Tarrant County, TX",1001177
"3298","2020","M10","October",71095,1104815,0.0643501400686993,2020-10-01,"Tarrant County, TX",1033720
"3299","2020","M11","November",70751,1097969,0.0644380670128209,2020-11-01,"Tarrant County, TX",1027218
"3300","2020","M12","December",68309,1104763,0.061831361115461,2020-12-01,"Tarrant County, TX",1036454
"3301","2021","M01","January",73992,1092288,0.067740376164528,2021-01-01,"Tarrant County, TX",1018296
"3302","2021","M02","February",77472,1084704,0.0714222497566156,2021-02-01,"Tarrant County, TX",1007232
"3303","2021","M03","March",74833,1089767,0.0686688071853892,2021-03-01,"Tarrant County, TX",1014934
"3304","2021","M04","April",65775,1087990,0.0604555188926369,2021-04-01,"Tarrant County, TX",1022215
"3305","2021","M05","May",60910,1089228,0.0559203399104687,2021-05-01,"Tarrant County, TX",1028318
"3306","2021","M06","June",68335,1092124,0.0625707337262069,2021-06-01,"Tarrant County, TX",1023789
"3307","2021","M07","July",61177,1093815,0.0559299333068206,2021-07-01,"Tarrant County, TX",1032638
"3308","2021","M08","August",54366,1097781,0.0495235388479123,2021-08-01,"Tarrant County, TX",1043415
"3309","2021","M09","September",50363,1109529,0.0453913327186581,2021-09-01,"Tarrant County, TX",1059166
"3310","2021","M10","October",48696,1117738,0.0435665603209339,2021-10-01,"Tarrant County, TX",1069042
"3311","2021","M11","November",46097,1131148,0.0407524037526477,2021-11-01,"Tarrant County, TX",1085051
"3312","2021","M12","December",42452,1130798,0.0375416298932258,2021-12-01,"Tarrant County, TX",1088346
"3313","2020","M01","January",8056,127808,0.0630320480721082,2020-01-01,"Toledo, OH",119752
"3314","2020","M02","February",7378,128638,0.0573547474307747,2020-02-01,"Toledo, OH",121260
"3315","2020","M03","March",9188,129155,0.0711393287135612,2020-03-01,"Toledo, OH",119967
"3316","2020","M04","April",33245,127612,0.260516252390057,2020-04-01,"Toledo, OH",94367
"3317","2020","M05","May",34079,135456,0.251587231278053,2020-05-01,"Toledo, OH",101377
"3318","2020","M06","June",19131,128593,0.148771706080424,2020-06-01,"Toledo, OH",109462
"3319","2020","M07","July",18719,130338,0.143618898556062,2020-07-01,"Toledo, OH",111619
"3320","2020","M08","August",17125,131984,0.129750575827373,2020-08-01,"Toledo, OH",114859
"3321","2020","M09","September",13574,129339,0.104949009966058,2020-09-01,"Toledo, OH",115765
"3322","2020","M10","October",8431,125776,0.0670318661747869,2020-10-01,"Toledo, OH",117345
"3323","2020","M11","November",8029,125354,0.0640506086762289,2020-11-01,"Toledo, OH",117325
"3324","2020","M12","December",8062,123551,0.0652524058890661,2020-12-01,"Toledo, OH",115489
"3325","2021","M01","January",10034,124005,0.0809160920930608,2021-01-01,"Toledo, OH",113971
"3326","2021","M02","February",9449,124906,0.0756488879637487,2021-02-01,"Toledo, OH",115457
"3327","2021","M03","March",8417,124772,0.0674590452986247,2021-03-01,"Toledo, OH",116355
"3328","2021","M04","April",9256,125535,0.0737324252200582,2021-04-01,"Toledo, OH",116279
"3329","2021","M05","May",9225,120548,0.0765255333974848,2021-05-01,"Toledo, OH",111323
"3330","2021","M06","June",10653,122035,0.0872946285901586,2021-06-01,"Toledo, OH",111382
"3331","2021","M07","July",11390,123579,0.0921677631312764,2021-07-01,"Toledo, OH",112189
"3332","2021","M08","August",9254,124049,0.0745995534022846,2021-08-01,"Toledo, OH",114795
"3333","2021","M09","September",7766,122699,0.063293099373263,2021-09-01,"Toledo, OH",114933
"3334","2021","M10","October",6464,123148,0.0524896872056387,2021-10-01,"Toledo, OH",116684
"3335","2021","M11","November",5931,122240,0.0485193062827225,2021-11-01,"Toledo, OH",116309
"3336","2021","M12","December",5200,123136,0.0422297297297297,2021-12-01,"Toledo, OH",117936
"3337","2020","M01","January",19819,751130,0.0263855790608816,2020-01-01,"Travis County, TX",731311
"3338","2020","M02","February",19211,757646,0.0253561689760125,2020-02-01,"Travis County, TX",738435
"3339","2020","M03","March",27250,737872,0.0369305245354208,2020-03-01,"Travis County, TX",710622
"3340","2020","M04","April",84889,700697,0.121149369841743,2020-04-01,"Travis County, TX",615808
"3341","2020","M05","May",76080,711147,0.106982100747103,2020-05-01,"Travis County, TX",635067
"3342","2020","M06","June",65985,741853,0.0889461928441349,2020-06-01,"Travis County, TX",675868
"3343","2020","M07","July",59821,742269,0.0805920764574568,2020-07-01,"Travis County, TX",682448
"3344","2020","M08","August",42450,749725,0.0566207609456801,2020-08-01,"Travis County, TX",707275
"3345","2020","M09","September",47330,743554,0.0636537494250586,2020-09-01,"Travis County, TX",696224
"3346","2020","M10","October",40160,755808,0.053135187772556,2020-10-01,"Travis County, TX",715648
"3347","2020","M11","November",38917,747189,0.0520845462125379,2020-11-01,"Travis County, TX",708272
"3348","2020","M12","December",37040,753258,0.0491730588988102,2020-12-01,"Travis County, TX",716218
"3349","2021","M01","January",40223,748301,0.0537524338468076,2021-01-01,"Travis County, TX",708078
"3350","2021","M02","February",41985,750909,0.0559122343719412,2021-02-01,"Travis County, TX",708924
"3351","2021","M03","March",40178,754921,0.0532214629080394,2021-03-01,"Travis County, TX",714743
"3352","2021","M04","April",34971,756577,0.0462226581035374,2021-04-01,"Travis County, TX",721606
"3353","2021","M05","May",32311,757440,0.0426581643430503,2021-05-01,"Travis County, TX",725129
"3354","2021","M06","June",35802,759754,0.0471231477557209,2021-06-01,"Travis County, TX",723952
"3355","2021","M07","July",31884,768246,0.0415023312845104,2021-07-01,"Travis County, TX",736362
"3356","2021","M08","August",28432,770956,0.0368788880299265,2021-08-01,"Travis County, TX",742524
"3357","2021","M09","September",26791,777158,0.034473041517941,2021-09-01,"Travis County, TX",750367
"3358","2021","M10","October",25994,786601,0.033045978838064,2021-10-01,"Travis County, TX",760607
"3359","2021","M11","November",24788,793398,0.0312428314666788,2021-11-01,"Travis County, TX",768610
"3360","2021","M12","December",22433,791176,0.0283539945599968,2021-12-01,"Travis County, TX",768743
"3361","2020","M01","January",22814,204502,0.111558811160771,2020-01-01,"Tulare County, CA",181688
"3362","2020","M02","February",23326,205976,0.113246203441178,2020-02-01,"Tulare County, CA",182650
"3363","2020","M03","March",27193,206179,0.131890250704485,2020-03-01,"Tulare County, CA",178986
"3364","2020","M04","April",37561,201485,0.186420825371616,2020-04-01,"Tulare County, CA",163924
"3365","2020","M05","May",33645,203859,0.165040542728062,2020-05-01,"Tulare County, CA",170214
"3366","2020","M06","June",30391,202483,0.150091612629208,2020-06-01,"Tulare County, CA",172092
"3367","2020","M07","July",29324,195971,0.149634384679366,2020-07-01,"Tulare County, CA",166647
"3368","2020","M08","August",25779,196826,0.130973550242346,2020-08-01,"Tulare County, CA",171047
"3369","2020","M09","September",23408,194135,0.12057588791305,2020-09-01,"Tulare County, CA",170727
"3370","2020","M10","October",21741,195058,0.111459155738293,2020-10-01,"Tulare County, CA",173317
"3371","2020","M11","November",18477,192076,0.0961962972989858,2020-11-01,"Tulare County, CA",173599
"3372","2020","M12","December",21926,191261,0.114639158009213,2020-12-01,"Tulare County, CA",169335
"3373","2021","M01","January",22387,195456,0.114537287164375,2021-01-01,"Tulare County, CA",173069
"3374","2021","M02","February",22833,197542,0.115585546364824,2021-02-01,"Tulare County, CA",174709
"3375","2021","M03","March",22455,193644,0.115960215653467,2021-03-01,"Tulare County, CA",171189
"3376","2021","M04","April",21621,197116,0.109686681953773,2021-04-01,"Tulare County, CA",175495
"3377","2021","M05","May",20449,201092,0.101689773834862,2021-05-01,"Tulare County, CA",180643
"3378","2021","M06","June",22448,202207,0.111014950026458,2021-06-01,"Tulare County, CA",179759
"3379","2021","M07","July",22197,198953,0.111569064050303,2021-07-01,"Tulare County, CA",176756
"3380","2021","M08","August",21118,199989,0.105595807769427,2021-08-01,"Tulare County, CA",178871
"3381","2021","M09","September",18658,200987,0.0928318746983636,2021-09-01,"Tulare County, CA",182329
"3382","2021","M10","October",18367,199321,0.0921478419233297,2021-10-01,"Tulare County, CA",180954
"3383","2021","M11","November",16531,200480,0.082457102952913,2021-11-01,"Tulare County, CA",183949
"3384","2021","M12","December",16610,197012,0.0843095852029318,2021-12-01,"Tulare County, CA",180402
"3385","2020","M01","January",9989,323777,0.0308514811119999,2020-01-01,"Tulsa County, OK",313788
"3386","2020","M02","February",9753,324801,0.0300276169100465,2020-02-01,"Tulsa County, OK",315048
"3387","2020","M03","March",10488,322427,0.0325282932260636,2020-03-01,"Tulsa County, OK",311939
"3388","2020","M04","April",44199,317285,0.139303780512788,2020-04-01,"Tulsa County, OK",273086
"3389","2020","M05","May",33965,322473,0.105326647502272,2020-05-01,"Tulsa County, OK",288508
"3390","2020","M06","June",29944,326011,0.0918496615144888,2020-06-01,"Tulsa County, OK",296067
"3391","2020","M07","July",26151,327788,0.0797802238031899,2020-07-01,"Tulsa County, OK",301637
"3392","2020","M08","August",21608,324659,0.066555986434998,2020-08-01,"Tulsa County, OK",303051
"3393","2020","M09","September",19562,325737,0.0600545839127885,2020-09-01,"Tulsa County, OK",306175
"3394","2020","M10","October",17233,324810,0.0530556325236292,2020-10-01,"Tulsa County, OK",307577
"3395","2020","M11","November",16487,325322,0.0506790195560091,2020-11-01,"Tulsa County, OK",308835
"3396","2020","M12","December",16009,323031,0.0495587110834564,2020-12-01,"Tulsa County, OK",307022
"3397","2021","M01","January",17673,325382,0.0543146209685846,2021-01-01,"Tulsa County, OK",307709
"3398","2021","M02","February",17498,323736,0.0540502137544172,2021-02-01,"Tulsa County, OK",306238
"3399","2021","M03","March",13837,322035,0.0429673793221234,2021-03-01,"Tulsa County, OK",308198
"3400","2021","M04","April",12039,319445,0.0376872388048021,2021-04-01,"Tulsa County, OK",307406
"3401","2021","M05","May",11596,324509,0.0357339858062488,2021-05-01,"Tulsa County, OK",312913
"3402","2021","M06","June",13046,329039,0.0396487954315446,2021-06-01,"Tulsa County, OK",315993
"3403","2021","M07","July",10412,328473,0.0316981913277499,2021-07-01,"Tulsa County, OK",318061
"3404","2021","M08","August",9475,323961,0.0292473476745658,2021-08-01,"Tulsa County, OK",314486
"3405","2021","M09","September",6876,323141,0.021278636879876,2021-09-01,"Tulsa County, OK",316265
"3406","2021","M10","October",7015,322343,0.0217625324576616,2021-10-01,"Tulsa County, OK",315328
"3407","2021","M11","November",6386,323693,0.019728569972165,2021-11-01,"Tulsa County, OK",317307
"3408","2021","M12","December",6049,323351,0.01870722527532,2021-12-01,"Tulsa County, OK",317302
"3409","2020","M01","January",6331,195962,0.032307284065278,2020-01-01,"Tulsa, OK",189631
"3410","2020","M02","February",6251,196642,0.0317887328241169,2020-02-01,"Tulsa, OK",190391
"3411","2020","M03","March",6814,195328,0.0348849115334207,2020-03-01,"Tulsa, OK",188514
"3412","2020","M04","April",28336,193385,0.146526359335005,2020-04-01,"Tulsa, OK",165049
"3413","2020","M05","May",22170,196528,0.112808353008223,2020-05-01,"Tulsa, OK",174358
"3414","2020","M06","June",19470,198397,0.0981365645649884,2020-06-01,"Tulsa, OK",178927
"3415","2020","M07","July",17560,199854,0.0878641408228006,2020-07-01,"Tulsa, OK",182294
"3416","2020","M08","August",14502,197656,0.0733698951714089,2020-08-01,"Tulsa, OK",183154
"3417","2020","M09","September",13243,198279,0.0667897255886907,2020-09-01,"Tulsa, OK",185036
"3418","2020","M10","October",11704,197608,0.0592283713209992,2020-10-01,"Tulsa, OK",185904
"3419","2020","M11","November",11113,197775,0.0561901150297055,2020-11-01,"Tulsa, OK",186662
"3420","2020","M12","December",10684,196233,0.0544454806276212,2020-12-01,"Tulsa, OK",185549
"3421","2021","M01","January",11646,197612,0.0589336679958707,2021-01-01,"Tulsa, OK",185966
"3422","2021","M02","February",11637,196716,0.059156347221375,2021-02-01,"Tulsa, OK",185079
"3423","2021","M03","March",9369,195621,0.0478936310518809,2021-03-01,"Tulsa, OK",186252
"3424","2021","M04","April",8259,194040,0.0425633889919604,2021-04-01,"Tulsa, OK",185781
"3425","2021","M05","May",7905,197010,0.0401248667580326,2021-05-01,"Tulsa, OK",189105
"3426","2021","M06","June",8703,199671,0.0435867001217002,2021-06-01,"Tulsa, OK",190968
"3427","2021","M07","July",7104,199323,0.0356406435785133,2021-07-01,"Tulsa, OK",192219
"3428","2021","M08","August",6363,196429,0.0323933838689806,2021-08-01,"Tulsa, OK",190066
"3429","2021","M09","September",4564,195696,0.0233218870084212,2021-09-01,"Tulsa, OK",191132
"3430","2021","M10","October",4616,195201,0.0236474198390377,2021-10-01,"Tulsa, OK",190585
"3431","2021","M11","November",4136,195912,0.0211115194577157,2021-11-01,"Tulsa, OK",191776
"3432","2021","M12","December",3875,195638,0.0198069904619757,2021-12-01,"Tulsa, OK",191763
"3433","2020","M01","January",7560,313697,0.0240996885529667,2020-01-01,"Utah County, UT",306137
"3434","2020","M02","February",7530,315199,0.0238896697007287,2020-02-01,"Utah County, UT",307669
"3435","2020","M03","March",8201,310898,0.0263784263649171,2020-03-01,"Utah County, UT",302697
"3436","2020","M04","April",23553,304792,0.0772756502795349,2020-04-01,"Utah County, UT",281239
"3437","2020","M05","May",16801,299824,0.0560362079086397,2020-05-01,"Utah County, UT",283023
"3438","2020","M06","June",15996,314984,0.0507835318619358,2020-06-01,"Utah County, UT",298988
"3439","2020","M07","July",13640,314904,0.0433147879988822,2020-07-01,"Utah County, UT",301264
"3440","2020","M08","August",12259,317106,0.0386589973068942,2020-08-01,"Utah County, UT",304847
"3441","2020","M09","September",10384,319118,0.0325396875137097,2020-09-01,"Utah County, UT",308734
"3442","2020","M10","October",8858,319189,0.0277515829179577,2020-10-01,"Utah County, UT",310331
"3443","2020","M11","November",8476,321974,0.0263251069962171,2020-11-01,"Utah County, UT",313498
"3444","2020","M12","December",8033,316587,0.0253737519228522,2020-12-01,"Utah County, UT",308554
"3445","2021","M01","January",9366,320257,0.0292452623986361,2021-01-01,"Utah County, UT",310891
"3446","2021","M02","February",9855,319195,0.0308745437741819,2021-02-01,"Utah County, UT",309340
"3447","2021","M03","March",7800,318118,0.0245192035659724,2021-03-01,"Utah County, UT",310318
"3448","2021","M04","April",7710,319284,0.024147780659225,2021-04-01,"Utah County, UT",311574
"3449","2021","M05","May",7544,320946,0.0235055118306506,2021-05-01,"Utah County, UT",313402
"3450","2021","M06","June",9037,323017,0.0279768557072848,2021-06-01,"Utah County, UT",313980
"3451","2021","M07","July",7450,322669,0.0230886760116404,2021-07-01,"Utah County, UT",315219
"3452","2021","M08","August",7459,325989,0.0228811401611711,2021-08-01,"Utah County, UT",318530
"3453","2021","M09","September",4460,329060,0.0135537591928524,2021-09-01,"Utah County, UT",324600
"3454","2021","M10","October",4133,332569,0.0124274962488987,2021-10-01,"Utah County, UT",328436
"3455","2021","M11","November",3953,335001,0.0117999647762245,2021-11-01,"Utah County, UT",331048
"3456","2021","M12","December",3856,331546,0.0116303620010496,2021-12-01,"Utah County, UT",327690
"3457","2020","M01","January",18646,599669,0.0310938200907501,2020-01-01,"Wake County, NC",581023
"3458","2020","M02","February",17650,604457,0.0291997611079035,2020-02-01,"Wake County, NC",586807
"3459","2020","M03","March",19868,578883,0.0343212704467051,2020-03-01,"Wake County, NC",559015
"3460","2020","M04","April",62648,544980,0.114954677235862,2020-04-01,"Wake County, NC",482332
"3461","2020","M05","May",69125,562515,0.122885611939237,2020-05-01,"Wake County, NC",493390
"3462","2020","M06","June",46346,568935,0.0814609753311011,2020-06-01,"Wake County, NC",522589
"3463","2020","M07","July",48505,589397,0.0822959736815762,2020-07-01,"Wake County, NC",540892
"3464","2020","M08","August",35095,581649,0.0603370761404215,2020-08-01,"Wake County, NC",546554
"3465","2020","M09","September",36787,590518,0.0622961535465473,2020-09-01,"Wake County, NC",553731
"3466","2020","M10","October",33348,596244,0.0559301225672711,2020-10-01,"Wake County, NC",562896
"3467","2020","M11","November",32062,596553,0.0537454341860656,2020-11-01,"Wake County, NC",564491
"3468","2020","M12","December",31100,595264,0.0522457262659929,2020-12-01,"Wake County, NC",564164
"3469","2021","M01","January",29289,590765,0.0495780894264217,2021-01-01,"Wake County, NC",561476
"3470","2021","M02","February",27626,594147,0.0464969106971844,2021-02-01,"Wake County, NC",566521
"3471","2021","M03","March",22499,594947,0.0378168139346866,2021-03-01,"Wake County, NC",572448
"3472","2021","M04","April",21393,593051,0.0360727829478409,2021-04-01,"Wake County, NC",571658
"3473","2021","M05","May",22094,590313,0.037427601967092,2021-05-01,"Wake County, NC",568219
"3474","2021","M06","June",24601,600026,0.0409998900047665,2021-06-01,"Wake County, NC",575425
"3475","2021","M07","July",23148,605585,0.0382241964381548,2021-07-01,"Wake County, NC",582437
"3476","2021","M08","August",21993,603570,0.0364381927531189,2021-08-01,"Wake County, NC",581577
"3477","2021","M09","September",18801,606541,0.0309970801644077,2021-09-01,"Wake County, NC",587740
"3478","2021","M10","October",18155,609062,0.0298081311918984,2021-10-01,"Wake County, NC",590907
"3479","2021","M11","November",16627,609575,0.0272763810851823,2021-11-01,"Wake County, NC",592948
"3480","2021","M12","December",15537,609439,0.0254939378674486,2021-12-01,"Wake County, NC",593902
"3481","2020","M01","January",4424,145797,0.0303435598812047,2020-01-01,"Washington County, MN",141373
"3482","2020","M02","February",4330,146568,0.0295426013863872,2020-02-01,"Washington County, MN",142238
"3483","2020","M03","March",5619,146266,0.0384163100105288,2020-03-01,"Washington County, MN",140647
"3484","2020","M04","April",12075,139211,0.086738835293188,2020-04-01,"Washington County, MN",127136
"3485","2020","M05","May",15235,142571,0.106859038654425,2020-05-01,"Washington County, MN",127336
"3486","2020","M06","June",12240,147321,0.0830838780621907,2020-06-01,"Washington County, MN",135081
"3487","2020","M07","July",10418,146184,0.0712663492584688,2020-07-01,"Washington County, MN",135766
"3488","2020","M08","August",8358,144566,0.0578144238617656,2020-08-01,"Washington County, MN",136208
"3489","2020","M09","September",7218,142589,0.0506210156463682,2020-09-01,"Washington County, MN",135371
"3490","2020","M10","October",5700,141089,0.040400031185989,2020-10-01,"Washington County, MN",135389
"3491","2020","M11","November",5230,140885,0.0371224757781169,2020-11-01,"Washington County, MN",135655
"3492","2020","M12","December",6044,139952,0.0431862352806677,2020-12-01,"Washington County, MN",133908
"3493","2021","M01","January",5886,138342,0.0425467320119703,2021-01-01,"Washington County, MN",132456
"3494","2021","M02","February",5768,139683,0.0412935002827832,2021-02-01,"Washington County, MN",133915
"3495","2021","M03","March",5346,140141,0.0381472945105287,2021-03-01,"Washington County, MN",134795
"3496","2021","M04","April",4916,140777,0.0349204770665663,2021-04-01,"Washington County, MN",135861
"3497","2021","M05","May",4564,141605,0.0322305003354401,2021-05-01,"Washington County, MN",137041
"3498","2021","M06","June",5557,141639,0.0392335444333835,2021-06-01,"Washington County, MN",136082
"3499","2021","M07","July",4155,141533,0.0293571110624377,2021-07-01,"Washington County, MN",137378
"3500","2021","M08","August",4214,140932,0.0299009451366617,2021-08-01,"Washington County, MN",136718
"3501","2021","M09","September",3585,140782,0.0254649031836456,2021-09-01,"Washington County, MN",137197
"3502","2021","M10","October",3043,140016,0.0217332304879442,2021-10-01,"Washington County, MN",136973
"3503","2021","M11","November",2666,140958,0.0189134352076505,2021-11-01,"Washington County, MN",138292
"3504","2021","M12","December",3139,140692,0.0223111477553805,2021-12-01,"Washington County, MN",137553
"3505","2020","M01","January",22361,407446,0.0548808921918487,2020-01-01,"Washington, DC",385085
"3506","2020","M02","February",21198,409582,0.0517552040861171,2020-02-01,"Washington, DC",388384
"3507","2020","M03","March",24492,403689,0.0606704666215825,2020-03-01,"Washington, DC",379197
"3508","2020","M04","April",40112,386730,0.103720942259458,2020-04-01,"Washington, DC",346618
"3509","2020","M05","May",33321,374683,0.0889311764878577,2020-05-01,"Washington, DC",341362
"3510","2020","M06","June",34498,381138,0.0905131474688958,2020-06-01,"Washington, DC",346640
"3511","2020","M07","July",36483,386985,0.0942749718981356,2020-07-01,"Washington, DC",350502
"3512","2020","M08","August",34452,387796,0.0888405243994265,2020-08-01,"Washington, DC",353344
"3513","2020","M09","September",35124,384831,0.0912712333465859,2020-09-01,"Washington, DC",349707
"3514","2020","M10","October",32754,386236,0.0848030737683696,2020-10-01,"Washington, DC",353482
"3515","2020","M11","November",30975,384299,0.0806013026315447,2020-11-01,"Washington, DC",353324
"3516","2020","M12","December",26402,379196,0.0696262618803996,2020-12-01,"Washington, DC",352794
"3517","2021","M01","January",22495,372598,0.0603733782790031,2021-01-01,"Washington, DC",350103
"3518","2021","M02","February",24737,377008,0.065613992276026,2021-02-01,"Washington, DC",352271
"3519","2021","M03","March",24808,377021,0.0658000482731731,2021-03-01,"Washington, DC",352213
"3520","2021","M04","April",24244,375753,0.0645211082812379,2021-04-01,"Washington, DC",351509
"3521","2021","M05","May",25128,377895,0.066494661215417,2021-05-01,"Washington, DC",352767
"3522","2021","M06","June",31121,385643,0.0806989884426789,2021-06-01,"Washington, DC",354522
"3523","2021","M07","July",29775,392284,0.0759016426874407,2021-07-01,"Washington, DC",362509
"3524","2021","M08","August",28115,383310,0.0733479429182646,2021-08-01,"Washington, DC",355195
"3525","2021","M09","September",25051,383024,0.0654032123313422,2021-09-01,"Washington, DC",357973
"3526","2021","M10","October",23819,384506,0.0619470177318429,2021-10-01,"Washington, DC",360687
"3527","2021","M11","November",22142,387907,0.0570806920215412,2021-11-01,"Washington, DC",365765
"3528","2021","M12","December",19706,383122,0.0514353130334463,2021-12-01,"Washington, DC",363416
"3529","2020","M01","January",9104,261929,0.0347575106231078,2020-01-01,"Washoe County, NV",252825
"3530","2020","M02","February",8129,265585,0.0306079033077922,2020-02-01,"Washoe County, NV",257456
"3531","2020","M03","March",14199,259372,0.0547437657110251,2020-03-01,"Washoe County, NV",245173
"3532","2020","M04","April",47566,239616,0.198509281517094,2020-04-01,"Washoe County, NV",192050
"3533","2020","M05","May",36345,234243,0.155159385766063,2020-05-01,"Washoe County, NV",197898
"3534","2020","M06","June",21520,250366,0.085954163105214,2020-06-01,"Washoe County, NV",228846
"3535","2020","M07","July",23763,247656,0.0959516426010272,2020-07-01,"Washoe County, NV",223893
"3536","2020","M08","August",19619,252412,0.0777260986007004,2020-08-01,"Washoe County, NV",232793
"3537","2020","M09","September",17582,257324,0.0683263123532978,2020-09-01,"Washoe County, NV",239742
"3538","2020","M10","October",15775,260447,0.0605689449292946,2020-10-01,"Washoe County, NV",244672
"3539","2020","M11","November",11578,260410,0.0444606581928497,2020-11-01,"Washoe County, NV",248832
"3540","2020","M12","December",11630,261978,0.0443930406370001,2020-12-01,"Washoe County, NV",250348
"3541","2021","M01","January",12717,264918,0.0480035331687541,2021-01-01,"Washoe County, NV",252201
"3542","2021","M02","February",13093,270421,0.0484170977845656,2021-02-01,"Washoe County, NV",257328
"3543","2021","M03","March",12463,268258,0.0464590058823968,2021-03-01,"Washoe County, NV",255795
"3544","2021","M04","April",13071,267417,0.0488787175086101,2021-04-01,"Washoe County, NV",254346
"3545","2021","M05","May",12178,267092,0.0455947763317509,2021-05-01,"Washoe County, NV",254914
"3546","2021","M06","June",12909,265061,0.0487019968988271,2021-06-01,"Washoe County, NV",252152
"3547","2021","M07","July",12976,262003,0.049526150463926,2021-07-01,"Washoe County, NV",249027
"3548","2021","M08","August",11067,260599,0.0424675459230465,2021-08-01,"Washoe County, NV",249532
"3549","2021","M09","September",9151,260577,0.0351182184152861,2021-09-01,"Washoe County, NV",251426
"3550","2021","M10","October",8379,264247,0.0317089692598213,2021-10-01,"Washoe County, NV",255868
"3551","2021","M11","November",7728,263519,0.0293261586451072,2021-11-01,"Washoe County, NV",255791
"3552","2021","M12","December",7457,262688,0.0283872883420636,2021-12-01,"Washoe County, NV",255231
"3553","2020","M01","January",6392,221992,0.028793830408303,2020-01-01,"Waukesha County, WI",215600
"3554","2020","M02","February",6171,223213,0.027646239242338,2020-02-01,"Waukesha County, WI",217042
"3555","2020","M03","March",6726,220323,0.0305279067550823,2020-03-01,"Waukesha County, WI",213597
"3556","2020","M04","April",28146,214986,0.130920152940191,2020-04-01,"Waukesha County, WI",186840
"3557","2020","M05","May",21207,217345,0.0975729830453887,2020-05-01,"Waukesha County, WI",196138
"3558","2020","M06","June",17542,220196,0.0796653890170575,2020-06-01,"Waukesha County, WI",202654
"3559","2020","M07","July",14781,222413,0.0664574462823666,2020-07-01,"Waukesha County, WI",207632
"3560","2020","M08","August",11771,222761,0.0528413860594987,2020-08-01,"Waukesha County, WI",210990
"3561","2020","M09","September",10066,225600,0.0446187943262411,2020-09-01,"Waukesha County, WI",215534
"3562","2020","M10","October",8727,220288,0.0396163204532249,2020-10-01,"Waukesha County, WI",211561
"3563","2020","M11","November",8063,219829,0.036678509204882,2020-11-01,"Waukesha County, WI",211766
"3564","2020","M12","December",7429,217026,0.0342309216407251,2020-12-01,"Waukesha County, WI",209597
"3565","2021","M01","January",7996,216132,0.0369959099069087,2021-01-01,"Waukesha County, WI",208136
"3566","2021","M02","February",8462,218336,0.0387567785431628,2021-02-01,"Waukesha County, WI",209874
"3567","2021","M03","March",8431,218770,0.0385381907939846,2021-03-01,"Waukesha County, WI",210339
"3568","2021","M04","April",7616,219332,0.0347236153411267,2021-04-01,"Waukesha County, WI",211716
"3569","2021","M05","May",7285,222026,0.0328114725302442,2021-05-01,"Waukesha County, WI",214741
"3570","2021","M06","June",8632,226838,0.0380535889048572,2021-06-01,"Waukesha County, WI",218206
"3571","2021","M07","July",7891,229183,0.0344310005541423,2021-07-01,"Waukesha County, WI",221292
"3572","2021","M08","August",7669,226296,0.0338892424081734,2021-08-01,"Waukesha County, WI",218627
"3573","2021","M09","September",5024,224501,0.0223785194720736,2021-09-01,"Waukesha County, WI",219477
"3574","2021","M10","October",4282,223994,0.0191165834799146,2021-10-01,"Waukesha County, WI",219712
"3575","2021","M11","November",3454,223591,0.0154478489742431,2021-11-01,"Waukesha County, WI",220137
"3576","2021","M12","December",3442,222633,0.0154604214110217,2021-12-01,"Waukesha County, WI",219191
"3577","2020","M01","January",9899,180886,0.0547250754618931,2020-01-01,"Westmoreland County, PA",170987
"3578","2020","M02","February",10078,181602,0.0554949835354236,2020-02-01,"Westmoreland County, PA",171524
"3579","2020","M03","March",10915,180021,0.0606318151771182,2020-03-01,"Westmoreland County, PA",169106
"3580","2020","M04","April",30275,174921,0.173078132414061,2020-04-01,"Westmoreland County, PA",144646
"3581","2020","M05","May",25160,177904,0.141424588542135,2020-05-01,"Westmoreland County, PA",152744
"3582","2020","M06","June",21834,178609,0.122244679719387,2020-06-01,"Westmoreland County, PA",156775
"3583","2020","M07","July",23374,179393,0.130294939044444,2020-07-01,"Westmoreland County, PA",156019
"3584","2020","M08","August",16984,173731,0.0977603306260829,2020-08-01,"Westmoreland County, PA",156747
"3585","2020","M09","September",11215,173887,0.0644959082622623,2020-09-01,"Westmoreland County, PA",162672
"3586","2020","M10","October",10305,173912,0.0592541055246332,2020-10-01,"Westmoreland County, PA",163607
"3587","2020","M11","November",10711,173477,0.0617430552753391,2020-11-01,"Westmoreland County, PA",162766
"3588","2020","M12","December",12172,172326,0.0706335666121189,2020-12-01,"Westmoreland County, PA",160154
"3589","2021","M01","January",14330,172498,0.0830734269382833,2021-01-01,"Westmoreland County, PA",158168
"3590","2021","M02","February",14277,174541,0.0817974000378135,2021-02-01,"Westmoreland County, PA",160264
"3591","2021","M03","March",12728,173574,0.0733289547973775,2021-03-01,"Westmoreland County, PA",160846
"3592","2021","M04","April",10758,172536,0.062352204757268,2021-04-01,"Westmoreland County, PA",161778
"3593","2021","M05","May",9661,172910,0.0558729975131571,2021-05-01,"Westmoreland County, PA",163249
"3594","2021","M06","June",11089,176026,0.0629963755354323,2021-06-01,"Westmoreland County, PA",164937
"3595","2021","M07","July",11688,177343,0.065906181805879,2021-07-01,"Westmoreland County, PA",165655
"3596","2021","M08","August",11321,175600,0.0644703872437358,2021-08-01,"Westmoreland County, PA",164279
"3597","2021","M09","September",8833,173022,0.0510513113939268,2021-09-01,"Westmoreland County, PA",164189
"3598","2021","M10","October",8083,172933,0.0467406452209815,2021-10-01,"Westmoreland County, PA",164850
"3599","2021","M11","November",7167,171407,0.0418127614391478,2021-11-01,"Westmoreland County, PA",164240
"3600","2021","M12","December",6741,168918,0.0399069370937378,2021-12-01,"Westmoreland County, PA",162177
"3601","2020","M01","January",10157,236465,0.0429535026325249,2020-01-01,"York County, PA",226308
"3602","2020","M02","February",10346,235990,0.0438408407135896,2020-02-01,"York County, PA",225644
"3603","2020","M03","March",10812,234159,0.0461737537314389,2020-03-01,"York County, PA",223347
"3604","2020","M04","April",35382,226122,0.156473054368881,2020-04-01,"York County, PA",190740
"3605","2020","M05","May",30714,233820,0.131357454452143,2020-05-01,"York County, PA",203106
"3606","2020","M06","June",27510,235736,0.11669834051651,2020-06-01,"York County, PA",208226
"3607","2020","M07","July",27404,236662,0.115793832554445,2020-07-01,"York County, PA",209258
"3608","2020","M08","August",20125,229856,0.0875548169288598,2020-08-01,"York County, PA",209731
"3609","2020","M09","September",13456,230767,0.058309896995671,2020-09-01,"York County, PA",217311
"3610","2020","M10","October",12363,230809,0.0535637691771118,2020-10-01,"York County, PA",218446
"3611","2020","M11","November",12423,231445,0.0536758193091231,2020-11-01,"York County, PA",219022
"3612","2020","M12","December",13071,231907,0.056363111074698,2020-12-01,"York County, PA",218836
"3613","2021","M01","January",15429,230647,0.0668944317506839,2021-01-01,"York County, PA",215218
"3614","2021","M02","February",15462,232975,0.0663676360124477,2021-02-01,"York County, PA",217513
"3615","2021","M03","March",13777,231145,0.0596032793268295,2021-03-01,"York County, PA",217368
"3616","2021","M04","April",12059,229701,0.0524986830706005,2021-04-01,"York County, PA",217642
"3617","2021","M05","May",11183,230362,0.0485453329976298,2021-05-01,"York County, PA",219179
"3618","2021","M06","June",12951,232785,0.0556350280301566,2021-06-01,"York County, PA",219834
"3619","2021","M07","July",13940,235007,0.0593173820354287,2021-07-01,"York County, PA",221067
"3620","2021","M08","August",13411,232970,0.0575653517620294,2021-08-01,"York County, PA",219559
"3621","2021","M09","September",10440,230577,0.0452777163377093,2021-09-01,"York County, PA",220137
"3622","2021","M10","October",9529,231252,0.041206130109145,2021-10-01,"York County, PA",221723
"3623","2021","M11","November",8179,229874,0.0355803614153841,2021-11-01,"York County, PA",221695
"3624","2021","M12","December",7253,226787,0.0319815509707347,2021-12-01,"York County, PA",219534
